# Extração das inflecções dos dicionários Hunspell pré e pós Acordo
# Sources: 
# https://github.com/TiagoSantos81/PortugueseLibreOfficeExtension/
# http://www.portaldalinguaportuguesa.org/recursos.html?action=novoacordo&act=list&version=all
#
ab-reação=ab-reacção
ab-reações=ab-reacções
abatista=abaptista
abatistas=abaptistas
abjeção=abjecção
abjecionista=abjeccionista
abjecionistas=abjeccionistas
abjeções=abjecções
abjeta=abjecta
abjetamente=abjectamente
abjetas=abjectas
abjeto=abjecto
abjetos=abjectos
abstração=abstracção
abstracionismo=abstraccionismo
abstracionismos=abstraccionismos
abstracionista=abstraccionista
abstracionistas=abstraccionistas
abstrações=abstracções
abstrata=abstracta
abstratamente=abstractamente
abstratas=abstractas
abstratício=abstractício
abstratícios=abstractícios
abstratismo=abstractismo
abstratismos=abstractismos
abstrativamente=abstractivamente
abstrativismo=abstractivismo
abstrativismos=abstractivismos
abstrativo=abstractivo
abstrativos=abstractivos
abstratizado=abstractizado
abstratizados=abstractizados
abstratizante=abstractizante
abstratizantes=abstractizantes
abstratizar=abstractizar
abstratizares=abstractizares
abstrato=abstracto
abstrator=abstractor
abstratores=abstractores
abstratos=abstractos
acataleto=acatalecto
acataletos=acatalectos
acatético=acatéctico
acatéticos=acatécticos
ação=acção
aciona=acciona
acionabilidade=accionabilidade
acionabilidades=accionabilidades
acionada=accionada
acionadamente=accionadamente
acionadas=accionadas
acionado=accionado
acionador=accionador
acionadora=accionadora
acionadoras=accionadoras
acionadores=accionadores
acionados=accionados
acionai=accionai
acionais=accionais
acional=accional
acionam=accionam
acionamento=accionamento
acionamentos=accionamentos
acionamos=accionamos
acionámos=accionámos
acionando=accionando
acionar=accionar
acionara=accionara
acionará=accionará
acionaram=accionaram
acionáramos=accionáramos
acionarão=accionarão
acionaras=accionaras
acionarás=accionarás
acionardes=accionardes
acionarei=accionarei
acionareis=accionareis
acionáreis=accionáreis
acionarem=accionarem
acionaremos=accionaremos
acionares=accionares
acionaria=accionaria
acionariam=accionariam
acionaríamos=accionaríamos
acionarias=accionarias
acionaríeis=accionaríeis
acionário=accionário
acionários=accionários
acionarmos=accionarmos
acionas=accionas
acionasse=accionasse
acionásseis=accionásseis
acionassem=accionassem
acionássemos=accionássemos
acionasses=accionasses
acionaste=accionaste
acionastes=accionastes
acionava=accionava
acionavam=accionavam
acionávamos=accionávamos
acionavas=accionavas
acionáveis=accionáveis
acionável=accionável
acione=accione
acionei=accionei
acioneis=accioneis
acionem=accionem
acionemos=accionemos
aciones=acciones
acionista=accionista
acionistas=accionistas
aciono=acciono
acionou=accionou
ações=acções
aceção=acepção
aceções=acepções
acetor=aceptor
acetores=aceptores
ata=acta
atas=actas
ativa=activa
ativação=activação
ativações=activações
ativada=activada
ativadas=activadas
ativado=activado
ativador=activador
ativadora=activadora
ativadoras=activadoras
ativadores=activadores
ativados=activados
ativai=activai
ativais=activais
ativam=activam
ativamente=activamente
ativamos=activamos
ativámos=activámos
ativando=activando
ativante=activante
ativantes=activantes
ativar=activar
ativara=activara
ativará=activará
ativaram=activaram
ativáramos=activáramos
ativarão=activarão
ativaras=activaras
ativarás=activarás
ativardes=activardes
ativarei=activarei
ativareis=activareis
ativáreis=activáreis
ativarem=activarem
ativaremos=activaremos
ativares=activares
ativaria=activaria
ativariam=activariam
ativaríamos=activaríamos
ativarias=activarias
ativaríeis=activaríeis
ativarmos=activarmos
ativas=activas
ativasse=activasse
ativásseis=activásseis
ativassem=activassem
ativássemos=activássemos
ativasses=activasses
ativaste=activaste
ativastes=activastes
ativava=activava
ativavam=activavam
ativávamos=activávamos
ativavas=activavas
ativáveis=activáveis
ativável=activável
ative=active
ativei=activei
ativeis=activeis
ativem=activem
ativemos=activemos
atives=actives
atividade=actividade
atividades=actividades
ativismo=activismo
ativismos=activismos
ativíssimo=activíssimo
ativíssimos=activíssimos
ativista=activista
ativistas=activistas
ativo=activo
ativos=activos
ativou=activou
ato=acto
ator=actor
atores=actores
atos=actos
atriz=actriz
atrizs=actrizs
atua=actua
atuação=actuação
atuações=actuações
atuada=actuada
atuadas=actuadas
atuado=actuado
atuador=actuador
atuadora=actuadora
atuadoras=actuadoras
atuadores=actuadores
atuados=actuados
atuai=actuai
atuais=actuais
atual=actual
atualidade=actualidade
atualidades=actualidades
atualismo=actualismo
atualismos=actualismos
atualíssimo=actualíssimo
atualíssimos=actualíssimos
atualista=actualista
atualistas=actualistas
atualiza=actualiza
atualização=actualização
atualizações=actualizações
atualizada=actualizada
atualizadas=actualizadas
atualizadíssima=actualizadíssima
atualizadíssimas=actualizadíssimas
atualizadíssimo=actualizadíssimo
atualizadíssimos=actualizadíssimos
atualizado=actualizado
atualizador=actualizador
atualizadora=actualizadora
atualizadoras=actualizadoras
atualizadores=actualizadores
atualizados=actualizados
atualizai=actualizai
atualizais=actualizais
atualizam=actualizam
atualizamos=actualizamos
atualizámos=actualizámos
atualizando=actualizando
atualizante=actualizante
atualizantes=actualizantes
atualizar=actualizar
atualizara=actualizara
atualizará=actualizará
atualizaram=actualizaram
atualizáramos=actualizáramos
atualizarão=actualizarão
atualizaras=actualizaras
atualizarás=actualizarás
atualizardes=actualizardes
atualizarei=actualizarei
atualizareis=actualizareis
atualizáreis=actualizáreis
atualizarem=actualizarem
atualizaremos=actualizaremos
atualizares=actualizares
atualizaria=actualizaria
atualizariam=actualizariam
atualizaríamos=actualizaríamos
atualizarias=actualizarias
atualizaríeis=actualizaríeis
atualizarmos=actualizarmos
atualizas=actualizas
atualizasse=actualizasse
atualizásseis=actualizásseis
atualizassem=actualizassem
atualizássemos=actualizássemos
atualizasses=actualizasses
atualizaste=actualizaste
atualizastes=actualizastes
atualizava=actualizava
atualizavam=actualizavam
atualizávamos=actualizávamos
atualizavas=actualizavas
atualizáveis=actualizáveis
atualizável=actualizável
atualize=actualize
atualizei=actualizei
atualizeis=actualizeis
atualizem=actualizem
atualizemos=actualizemos
atualizes=actualizes
atualizo=actualizo
atualizou=actualizou
atualmente=actualmente
atuam=actuam
atuamos=actuamos
atuámos=actuámos
atuando=actuando
atuante=actuante
atuantes=actuantes
atuar=actuar
atuara=actuara
atuará=actuará
atuaram=actuaram
atuáramos=actuáramos
atuarão=actuarão
atuaras=actuaras
atuarás=actuarás
atuardes=actuardes
atuarei=actuarei
atuareis=actuareis
atuáreis=actuáreis
atuarem=actuarem
atuaremos=actuaremos
atuares=actuares
atuaria=actuaria
atuária=actuária
atuariado=actuariado
atuariados=actuariados
atuariais=actuariais
atuarial=actuarial
atuariam=actuariam
atuaríamos=actuaríamos
atuarias=actuarias
atuárias=actuárias
atuaríeis=actuaríeis
atuário=actuário
atuários=actuários
atuarmos=actuarmos
atuas=actuas
atuasse=actuasse
atuásseis=actuásseis
atuassem=actuassem
atuássemos=actuássemos
atuasses=actuasses
atuaste=actuaste
atuastes=actuastes
atuava=actuava
atuavam=actuavam
atuávamos=actuávamos
atuavas=actuavas
atuáveis=actuáveis
atuável=actuável
atue=actue
atuei=actuei
atueis=actueis
atuem=actuem
atuemos=actuemos
atues=actues
atuo=actuo
atuosamente=actuosamente
atuosidade=actuosidade
atuosidades=actuosidades
atuoso=actuoso
atuosos=actuosos
atuou=actuou
acupuntura	# Dupla grafia=# acupunctura
acupunturas	# Dupla grafia=# acupuncturas
adjeção=adjecção
adjeções=adjecções
adjetiva=adjectiva
adjetivação=adjectivação
adjetivações=adjectivações
adjetivada=adjectivada
adjetivadas=adjectivadas
adjetivado=adjectivado
adjetivados=adjectivados
adjetivai=adjectivai
adjetivais=adjectivais
adjetival=adjectival
adjetivalização=adjectivalização
adjetivalizações=adjectivalizações
adjetivam=adjectivam
adjetivamente=adjectivamente
adjetivamento=adjectivamento
adjetivamentos=adjectivamentos
adjetivamos=adjectivamos
adjetivámos=adjectivámos
adjetivando=adjectivando
adjetivar=adjectivar
adjetivara=adjectivara
adjetivará=adjectivará
adjetivaram=adjectivaram
adjetiváramos=adjectiváramos
adjetivarão=adjectivarão
adjetivaras=adjectivaras
adjetivarás=adjectivarás
adjetivardes=adjectivardes
adjetivarei=adjectivarei
adjetivareis=adjectivareis
adjetiváreis=adjectiváreis
adjetivarem=adjectivarem
adjetivaremos=adjectivaremos
adjetivares=adjectivares
adjetivaria=adjectivaria
adjetivariam=adjectivariam
adjetivaríamos=adjectivaríamos
adjetivarias=adjectivarias
adjetivaríeis=adjectivaríeis
adjetivarmos=adjectivarmos
adjetivas=adjectivas
adjetivasse=adjectivasse
adjetivásseis=adjectivásseis
adjetivassem=adjectivassem
adjetivássemos=adjectivássemos
adjetivasses=adjectivasses
adjetivaste=adjectivaste
adjetivastes=adjectivastes
adjetivava=adjectivava
adjetivavam=adjectivavam
adjetivávamos=adjectivávamos
adjetivavas=adjectivavas
adjetiváveis=adjectiváveis
adjetivável=adjectivável
adjetive=adjective
adjetivei=adjectivei
adjetiveis=adjectiveis
adjetivem=adjectivem
adjetivemos=adjectivemos
adjetives=adjectives
adjetividade=adjectividade
adjetividades=adjectividades
adjetivo=adjectivo
adjetivos=adjectivos
adjetivou=adjectivou
adjeto=adjecto
adjetos=adjectos
adoção=adopção
adocianismo=adopcianismo
adocianismos=adopcianismos
adociano=adopciano
adocianos=adopcianos
adocionismo=adopcionismo
adocionismos=adopcionismos
adoções=adopções
adota=adopta
adotação=adoptação
adotações=adoptações
adotada=adoptada
adotadas=adoptadas
adotado=adoptado
adotados=adoptados
adotai=adoptai
adotais=adoptais
adotam=adoptam
adotamos=adoptamos
adotámos=adoptámos
adotando=adoptando
adotante=adoptante
adotantes=adoptantes
adotar=adoptar
adotara=adoptara
adotará=adoptará
adotaram=adoptaram
adotáramos=adoptáramos
adotarão=adoptarão
adotaras=adoptaras
adotarás=adoptarás
adotardes=adoptardes
adotarei=adoptarei
adotareis=adoptareis
adotáreis=adoptáreis
adotarem=adoptarem
adotaremos=adoptaremos
adotares=adoptares
adotaria=adoptaria
adotariam=adoptariam
adotaríamos=adoptaríamos
adotarias=adoptarias
adotaríeis=adoptaríeis
adotarmos=adoptarmos
adotas=adoptas
adotasse=adoptasse
adotásseis=adoptásseis
adotassem=adoptassem
adotássemos=adoptássemos
adotasses=adoptasses
adotaste=adoptaste
adotastes=adoptastes
adotava=adoptava
adotavam=adoptavam
adotávamos=adoptávamos
adotavas=adoptavas
adotáveis=adoptáveis
adotável=adoptável
adote=adopte
adotei=adoptei
adoteis=adopteis
adotem=adoptem
adotemos=adoptemos
adotes=adoptes
adotiva=adoptiva
adotivamente=adoptivamente
adotivas=adoptivas
adotivo=adoptivo
adotivos=adoptivos
adoto=adopto
adotou=adoptou
afeção=afecção
afecionais=afeccionais
afecional=afeccional
afecionalidade=afeccionalidade
afecionalidades=afeccionalidades
afeções=afecções
afeta=afecta
afetação=afectação
afetações=afectações
afetada=afectada
afetadamente=afectadamente
afetadas=afectadas
afetado=afectado
afetador=afectador
afetadores=afectadores
afetados=afectados
afetai=afectai
afetais=afectais
afetam=afectam
afetamos=afectamos
afetámos=afectámos
afetando=afectando
afetante=afectante
afetantes=afectantes
afetar=afectar
afetara=afectara
afetará=afectará
afetaram=afectaram
afetáramos=afectáramos
afetarão=afectarão
afetaras=afectaras
afetarás=afectarás
afetardes=afectardes
afetarei=afectarei
afetareis=afectareis
afetáreis=afectáreis
afetarem=afectarem
afetaremos=afectaremos
afetares=afectares
afetaria=afectaria
afetariam=afectariam
afetaríamos=afectaríamos
afetarias=afectarias
afetaríeis=afectaríeis
afetarmos=afectarmos
afetas=afectas
afetasse=afectasse
afetásseis=afectásseis
afetassem=afectassem
afetássemos=afectássemos
afetasses=afectasses
afetaste=afectaste
afetastes=afectastes
afetativo=afectativo
afetativos=afectativos
afetava=afectava
afetavam=afectavam
afetávamos=afectávamos
afetavas=afectavas
afetáveis=afectáveis
afetável=afectável
afete=afecte
afetei=afectei
afeteis=afecteis
afetem=afectem
afetemos=afectemos
afetes=afectes
afetiva=afectiva
afetivamente=afectivamente
afetivas=afectivas
afetíveis=afectíveis
afetível=afectível
afetividade=afectividade
afetividades=afectividades
afetivo=afectivo
afetivos=afectivos
afeto=afecto
afetos=afectos
afetou=afectou
afetuosa=afectuosa
afetuosamente=afectuosamente
afetuosas=afectuosas
afetuosidade=afectuosidade
afetuosidades=afectuosidades
afetuoso=afectuoso
afetuosos=afectuosos
afilático=afiláctico
afiláticos=afilácticos
agroalimentar=agro-alimentar
agroalimentares=agro-alimentares
alcalinoterroso=alcalino-terroso
almorroida=almorróida
almorroidas=almorróidas
amiotático=amiotáctico
amiotáticos=amiotácticos
ampletivo=amplectivo
ampletivos=amplectivos
anabatismo=anabaptismo
anabatismos=anabaptismos
anabatista=anabaptista
anabatistas=anabaptistas
anafilático=anafiláctico
anafiláticos=anafilácticos
anaptítico=anaptíctico
anaptíticos=anaptícticos
androlético=androléptico
androléticos=androlépticos
anelétrico=aneléctrico
anelétricos=aneléctricos
aneletródio=anelectródio
aneletródios=anelectródios
anelétrodo=aneléctrodo
anelétrodos=aneléctrodos
angietático=angiectático
angietáticos=angiectáticos
anótico=anóptico
anóticos=anópticos
anorética=anoréctica
anoréticas=anorécticas
anorético=anoréctico
anoréticos=anorécticos
antártia=antárctia
antártias=antárctias
antártica=antárctica
antárticas=antárcticas
antártico=antárctico
antárticos=antárcticos
Antártida=Antárctida
antasfítico=antasfíctico
antasfíticos=antasfícticos
anteato=anteacto
anteatos=anteactos
anteprojeto=anteprojecto
anteprojetos=anteprojectos
anti-infecioso=anti-infeccioso
antirracional=anti-racional
antirraquítico=anti-raquítico
antirrealismo=anti-realismo
antirrugas=anti-rugas
antissética=anti-séptica
antisséticas=anti-sépticas
antissético=anti-séptico
antisséticos=anti-sépticos
antiterrorismo=anti-terrorismo
antiapoplético=antiapopléctico
antiapopléticos=antiapoplécticos
antiatático=antiatáctico
antiatáticos=antiatácticos
anticaquético=anticaquéctico
anticaquéticos=anticaquécticos
anticética=anticéptica
anticéticas=anticépticas
anticeticismo=anticepticismo
anticeticismos=anticepticismos
anticético=anticéptico
anticéticos=anticépticos
anticoncecionais=anticoncepcionais
anticoncecional=anticoncepcional
anticoncetivo=anticonceptivo
anticoncetivos=anticonceptivos
antiepilético=antiepiléptico
antiepiléticos=antiepilépticos
antiferroeletricidade=antiferroelectricidade
antiferroeletricidades=antiferroelectricidades
antiferroelétrico=antiferroeléctrico
antiferroelétricos=antiferroeléctricos
antimetalético=antimetaléptico
antimetaléticos=antimetalépticos
antiprático=antipráctico
antipráticos=antiprácticos
antropotático=antropotáctico
antropotáticos=antropotácticos
aperceção=apercepção
aperceções=apercepções
apercetibilidade=aperceptibilidade
apercetibilidades=aperceptibilidades
apercetíveis=aperceptíveis
apercetível=aperceptível
apercetivo=aperceptivo
apercetivos=aperceptivos
apocaliticismo=apocalipticismo
apocaliticismos=apocalipticismos
apodítica=apodíctica
apodíticas=apodícticas
apodítico=apodíctico
apodíticos=apodícticos
apomítico=apomíctico
apomíticos=apomícticos
apoplético=apopléctico
apopléticos=apoplécticos
apossético=aposséptico
aposséticos=apossépticos
apotático=apotáctico
apotáticos=apotácticos
aprático=apráctico
apráticos=aprácticos
ártica=árctica
árticas=árcticas
ártico=árctico
artícola=arctícola
artícolas=arctícolas
árticos=árcticos
arefação=arefacção
arefações=arefacções
arquiteta=arquitecta
arquitetação=arquitectação
arquitetações=arquitectações
arquitetada=arquitectada
arquitetadas=arquitectadas
arquitetado=arquitectado
arquitetados=arquitectados
arquitetai=arquitectai
arquitetais=arquitectais
arquitetam=arquitectam
arquitetamos=arquitectamos
arquitetámos=arquitectámos
arquitetando=arquitectando
arquitetar=arquitectar
arquitetara=arquitectara
arquitetará=arquitectará
arquitetaram=arquitectaram
arquitetáramos=arquitectáramos
arquitetarão=arquitectarão
arquitetaras=arquitectaras
arquitetarás=arquitectarás
arquitetardes=arquitectardes
arquitetarei=arquitectarei
arquitetareis=arquitectareis
arquitetáreis=arquitectáreis
arquitetarem=arquitectarem
arquitetaremos=arquitectaremos
arquitetares=arquitectares
arquitetaria=arquitectaria
arquitetariam=arquitectariam
arquitetaríamos=arquitectaríamos
arquitetarias=arquitectarias
arquitetaríeis=arquitectaríeis
arquitetarmos=arquitectarmos
arquitetas=arquitectas
arquitetasse=arquitectasse
arquitetásseis=arquitectásseis
arquitetassem=arquitectassem
arquitetássemos=arquitectássemos
arquitetasses=arquitectasses
arquitetaste=arquitectaste
arquitetastes=arquitectastes
arquitetava=arquitectava
arquitetavam=arquitectavam
arquitetávamos=arquitectávamos
arquitetavas=arquitectavas
arquitetáveis=arquitectáveis
arquitetável=arquitectável
arquitete=arquitecte
arquitetei=arquitectei
arquiteteis=arquitecteis
arquitetem=arquitectem
arquitetemos=arquitectemos
arquitetes=arquitectes
arquiteto=arquitecto
arquitetónica=arquitectónica
arquitetonicamente=arquitectonicamente
arquitetónicas=arquitectónicas
arquitetónico=arquitectónico
arquitetónicos=arquitectónicos
arquitetonografia=arquitectonografia
arquitetonografias=arquitectonografias
arquitetonográfico=arquitectonográfico
arquitetonográficos=arquitectonográficos
arquitetonógrafo=arquitectonógrafo
arquitetonógrafos=arquitectonógrafos
arquitetor=arquitector
arquitetores=arquitectores
arquitetos=arquitectos
arquitetou=arquitectou
arquitetura=arquitectura
arquiteturais=arquitecturais
arquitetural=arquitectural
arquiteturas=arquitecturas
arquiteturismo=arquitecturismo
arquiteturismos=arquitecturismos
arquiteturista=arquitecturista
arquiteturistas=arquitecturistas
aspeto=aspecto
aspetos=aspectos
aspetuais=aspectuais
aspetual=aspectual
assintaticamente=assintacticamente
assintático=assintáctico
assintáticos=assintácticos
assuncionista=assumpcionista
assuncionistas=assumpcionistas
atração=atracção
atrações=atracções
atrativa=atractiva
atrativamente=atractivamente
atrativas=atractivas
atratividade=atractividade
atratividades=atractividades
atrativo=atractivo
atrativos=atractivos
aurifatório=aurifactório
aurifatórios=aurifactórios
autoajuda=auto-ajuda
autoaprendizagem=auto-aprendizagem
autoavaliação=auto-avaliação
autoavaliações=auto-avaliações
autoavaliar=auto-avaliar
autoestima=auto-estima
autoestrada=auto-estrada
autoestradas=auto-estradas
autorrádio=auto-rádio
autorrádios=auto-rádios
autorretrato=auto-retrato
autorretratos=auto-retratos
autossuficiência=auto-suficiência
autossuficiências=auto-suficiências
autossugestão=auto-sugestão
autossugestiona=auto-sugestiona
autossugestionada=auto-sugestionada
autossugestionadas=auto-sugestionadas
autossugestionado=auto-sugestionado
autossugestionados=auto-sugestionados
autossugestionai=auto-sugestionai
autossugestionais=auto-sugestionais
autossugestionam=auto-sugestionam
autossugestionamos=auto-sugestionamos
autossugestionámos=auto-sugestionámos
autossugestionando=auto-sugestionando
autossugestionar=auto-sugestionar
autossugestionara=auto-sugestionara
autossugestionará=auto-sugestionará
autossugestionaram=auto-sugestionaram
autossugestionáramos=auto-sugestionáramos
autossugestionarão=auto-sugestionarão
autossugestionaras=auto-sugestionaras
autossugestionarás=auto-sugestionarás
autossugestionardes=auto-sugestionardes
autossugestionarei=auto-sugestionarei
autossugestionareis=auto-sugestionareis
autossugestionáreis=auto-sugestionáreis
autossugestionarem=auto-sugestionarem
autossugestionaremos=auto-sugestionaremos
autossugestionares=auto-sugestionares
autossugestionaria=auto-sugestionaria
autossugestionariam=auto-sugestionariam
autossugestionaríamos=auto-sugestionaríamos
autossugestionarias=auto-sugestionarias
autossugestionaríeis=auto-sugestionaríeis
autossugestionarmos=auto-sugestionarmos
autossugestionas=auto-sugestionas
autossugestionasse=auto-sugestionasse
autossugestionásseis=auto-sugestionásseis
autossugestionassem=auto-sugestionassem
autossugestionássemos=auto-sugestionássemos
autossugestionasses=auto-sugestionasses
autossugestionaste=auto-sugestionaste
autossugestionastes=auto-sugestionastes
autossugestionava=auto-sugestionava
autossugestionavam=auto-sugestionavam
autossugestionávamos=auto-sugestionávamos
autossugestionavas=auto-sugestionavas
autossugestionáveis=auto-sugestionáveis
autossugestione=auto-sugestione
autossugestionei=auto-sugestionei
autossugestioneis=auto-sugestioneis
autossugestionem=auto-sugestionem
autossugestionemos=auto-sugestionemos
autossugestiones=auto-sugestiones
autossugestiono=auto-sugestiono
autossugestionou=auto-sugestionou
autotanque=auto-tanque
autotanques=auto-tanques
autocorreção=autocorrecção
autocorreções=autocorrecções
autocorretivo=autocorrectivo
autocorretivos=autocorrectivos
autocorretor=autocorrector
autocorretores=autocorrectores
autodidata=autodidacta
autodidatas=autodidactas
autodidática=autodidáctica
autodidaticamente=autodidacticamente
autodidáticas=autodidácticas
autodidático=autodidáctico
autodidáticos=autodidácticos
autodidatismo=autodidactismo
autodidatismos=autodidactismos
autoprojeção=autoprojecção
autoprojeções=autoprojecções
autoprojetor=autoprojector
autoprojetores=autoprojectores
autoproteção=autoprotecção
autoproteções=autoprotecções
autotrator=autotractor
autotratores=autotractores
batismais=baptismais
batismal=baptismal
batismo=baptismo
batismos=baptismos
batista=baptista
batistas=baptistas
batistério=baptistério
batistérios=baptistérios
batistino=baptistino
batistinos=baptistinos
batiza=baptiza
batizada=baptizada
batizadas=baptizadas
batizado=baptizado
batizados=baptizados
batizai=baptizai
batizais=baptizais
batizam=baptizam
batizamento=baptizamento
batizamentos=baptizamentos
batizamos=baptizamos
batizámos=baptizámos
batizando=baptizando
batizandos=baptizandos
batizante=baptizante
batizantes=baptizantes
batizar=baptizar
batizara=baptizara
batizará=baptizará
batizaram=baptizaram
batizáramos=baptizáramos
batizarão=baptizarão
batizaras=baptizaras
batizarás=baptizarás
batizardes=baptizardes
batizarei=baptizarei
batizareis=baptizareis
batizáreis=baptizáreis
batizarem=baptizarem
batizaremos=baptizaremos
batizares=baptizares
batizaria=baptizaria
batizariam=baptizariam
batizaríamos=baptizaríamos
batizarias=baptizarias
batizaríeis=baptizaríeis
batizarmos=baptizarmos
batizas=baptizas
batizasse=baptizasse
batizásseis=baptizásseis
batizassem=baptizassem
batizássemos=baptizássemos
batizasses=baptizasses
batizaste=baptizaste
batizastes=baptizastes
batizava=baptizava
batizavam=baptizavam
batizávamos=baptizávamos
batizavas=baptizavas
batizáveis=baptizáveis
batize=baptize
batizei=baptizei
batizeis=baptizeis
batizem=baptizem
batizemos=baptizemos
batizes=baptizes
batizo=baptizo
batizos=baptizos
batizou=baptizou
barotático=barotáctico
barotáticos=barotácticos
beltrano=Beltrano
beltranos=Beltranos
bibliofilático=bibliofiláctico
bibliofiláticos=bibliofilácticos
bidirecionais=bidireccionais
bidirecional=bidireccional
bijeção=bijecção
bijeções=bijecções
bijetiva=bijectiva
bioatividade=bioactividade
bioatividades=bioactividades
bioativo=bioactivo
bioativos=bioactivos
biobjetividade=biobjectividade
biobjetividades=biobjectividades
biobjetivo=biobjectivo
biobjetivos=biobjectivos
bioeletricidade=bioelectricidade
bioeletricidades=bioelectricidades
bioelétrico=bioeléctrico
bioelétricos=bioeléctricos
biotático=biotáctico
biotáticos=biotácticos
birreator=birreactor
birreatores=birreactores
birrefração=birrefracção
birrefrações=birrefracções
bisseta=bissecta
bissetada=bissectada
bissetadas=bissectadas
bissetado=bissectado
bissetados=bissectados
bissetai=bissectai
bissetais=bissectais
bissetam=bissectam
bissetamos=bissectamos
bissetámos=bissectámos
bissetando=bissectando
bissetar=bissectar
bissetara=bissectara
bissetará=bissectará
bissetaram=bissectaram
bissetáramos=bissectáramos
bissetarão=bissectarão
bissetaras=bissectaras
bissetarás=bissectarás
bissetardes=bissectardes
bissetarei=bissectarei
bissetareis=bissectareis
bissetáreis=bissectáreis
bissetarem=bissectarem
bissetaremos=bissectaremos
bissetares=bissectares
bissetaria=bissectaria
bissetariam=bissectariam
bissetaríamos=bissectaríamos
bissetarias=bissectarias
bissetaríeis=bissectaríeis
bissetarmos=bissectarmos
bissetas=bissectas
bissetasse=bissectasse
bissetásseis=bissectásseis
bissetassem=bissectassem
bissetássemos=bissectássemos
bissetasses=bissectasses
bissetaste=bissectaste
bissetastes=bissectastes
bissetava=bissectava
bissetavam=bissectavam
bissetávamos=bissectávamos
bissetavas=bissectavas
bissetáveis=bissectáveis
bissete=bissecte
bissetei=bissectei
bisseteis=bissecteis
bissetem=bissectem
bissetemos=bissectemos
bissetes=bissectes
bisseto=bissecto
bissetor=bissector
bissetou=bissectou
bissetriz=bissectriz
bissetrizes=bissectrizes
bissetrizs=bissectrizs
braquicatalético=braquicataléctico
braquicataléticos=braquicatalécticos
braquicataleto=braquicatalecto
braquicataletos=braquicatalectos
bronquetásico=bronquectásico
bronquetásicos=bronquectásicos
bronquetático=bronquectático
bronquetáticos=bronquectáticos
busca-polos=busca-pólos
cato=cacto
catos=cactos
calefação=calefacção
calefações=calefacções
calefator=calefactor
calefatores=calefactores
calefatório=calefactório
calefatórios=calefactórios
Camboja=Cambodja
caquética=caquéctica
caqueticamente=caquecticamente
caquéticas=caquécticas
caquético=caquéctico
caquéticos=caquécticos
cardiorrético=cardiorréctico
cardiorréticos=cardiorrécticos
catabatismo=catabaptismo
catabatismos=catabaptismos
catabatista=catabaptista
catabatistas=catabaptistas
catafilático=catafiláctico
catafiláticos=catafilácticos
catalético=cataléctico
cataléticos=catalécticos
cataleto=catalecto
cataletos=catalectos
catarrético=catarréctico
catarréticos=catarrécticos
cética=céptica
céticas=cépticas
ceticismo=cepticismo
ceticismos=cepticismos
cético=céptico
céticos=cépticos
cetrífero=ceptrífero
cetríferos=ceptríferos
cetrígero=ceptrígero
cetrígeros=ceptrígeros
cetro=ceptro
cetros=ceptros
chacoina=chacóina
chacoinas=chacóinas
cineteatro=cine-teatro
cineteatros=cine-teatros
cinorético=cinoréctico
cinoréticos=cinorécticos
ciótico=cióptico
cióticos=ciópticos
circunspeção=circunspecção
circunspecionar=circunspeccionar
circunspecionares=circunspeccionares
circunspeções=circunspecções
circunspeta=circunspecta
circunspetas=circunspectas
circunspeto=circunspecto
circunspetos=circunspectos
citofilático=citofiláctico
citofiláticos=citofilácticos
citopético=citopéctico
citopéticos=citopécticos
clidorrético=clidorréctico
clidorréticos=clidorrécticos
coacusado=co-acusado
coacusados=co-acusados
coadministra=co-administra
coadministrada=co-administrada
coadministradas=co-administradas
coadministrado=co-administrado
coadministrador=co-administrador
coadministrados=co-administrados
coadministrai=co-administrai
coadministrais=co-administrais
coadministram=co-administram
coadministramos=co-administramos
coadministrámos=co-administrámos
coadministrando=co-administrando
coadministrar=co-administrar
coadministrara=co-administrara
coadministrará=co-administrará
coadministraram=co-administraram
coadministráramos=co-administráramos
coadministrarão=co-administrarão
coadministraras=co-administraras
coadministrarás=co-administrarás
coadministrardes=co-administrardes
coadministrarei=co-administrarei
coadministrareis=co-administrareis
coadministráreis=co-administráreis
coadministrarem=co-administrarem
coadministraremos=co-administraremos
coadministrares=co-administrares
coadministraria=co-administraria
coadministrariam=co-administrariam
coadministraríamos=co-administraríamos
coadministrarias=co-administrarias
coadministraríeis=co-administraríeis
coadministrarmos=co-administrarmos
coadministras=co-administras
coadministrasse=co-administrasse
coadministrásseis=co-administrásseis
coadministrassem=co-administrassem
coadministrássemos=co-administrássemos
coadministrasses=co-administrasses
coadministraste=co-administraste
coadministrastes=co-administrastes
coadministrava=co-administrava
coadministravam=co-administravam
coadministrávamos=co-administrávamos
coadministravas=co-administravas
coadministráveis=co-administráveis
coadministre=co-administre
coadministrei=co-administrei
coadministreis=co-administreis
coadministrem=co-administrem
coadministremos=co-administremos
coadministres=co-administres
coadministro=co-administro
coadministrou=co-administrou
coaluno=co-aluno
coarrenda=co-arrenda
coarrendada=co-arrendada
coarrendadas=co-arrendadas
coarrendado=co-arrendado
coarrendados=co-arrendados
coarrendai=co-arrendai
coarrendais=co-arrendais
coarrendam=co-arrendam
coarrendamos=co-arrendamos
coarrendámos=co-arrendámos
coarrendando=co-arrendando
coarrendar=co-arrendar
coarrendara=co-arrendara
coarrendará=co-arrendará
coarrendaram=co-arrendaram
coarrendáramos=co-arrendáramos
coarrendarão=co-arrendarão
coarrendaras=co-arrendaras
coarrendarás=co-arrendarás
coarrendardes=co-arrendardes
coarrendarei=co-arrendarei
coarrendareis=co-arrendareis
coarrendáreis=co-arrendáreis
coarrendarem=co-arrendarem
coarrendaremos=co-arrendaremos
coarrendares=co-arrendares
coarrendaria=co-arrendaria
coarrendariam=co-arrendariam
coarrendaríamos=co-arrendaríamos
coarrendarias=co-arrendarias
coarrendaríeis=co-arrendaríeis
coarrendarmos=co-arrendarmos
coarrendas=co-arrendas
coarrendasse=co-arrendasse
coarrendásseis=co-arrendásseis
coarrendassem=co-arrendassem
coarrendássemos=co-arrendássemos
coarrendasses=co-arrendasses
coarrendaste=co-arrendaste
coarrendastes=co-arrendastes
coarrendatário=co-arrendatário
coarrendava=co-arrendava
coarrendavam=co-arrendavam
coarrendávamos=co-arrendávamos
coarrendavas=co-arrendavas
coarrendáveis=co-arrendáveis
coarrende=co-arrende
coarrendei=co-arrendei
coarrendeis=co-arrendeis
coarrendem=co-arrendem
coarrendemos=co-arrendemos
coarrendes=co-arrendes
coarrendo=co-arrendo
coarrendou=co-arrendou
coassociado=co-associado
coautor=co-autor
coautores=co-autores
coautoria=co-autoria
codelinquência=co-delinquência
codelinquências=co-delinquências
codelinquente=co-delinquente
codetentor=co-detentor
codialeto=co-dialecto
codiretor=co-director
codonatário=co-donatário
coeleitor=co-eleitor
coeternidade=co-eternidade
coeternidades=co-eternidades
coeterno=co-eterno
cogerência=co-gerência
cogerências=co-gerências
cogerente=co-gerente
coinquilino=co-inquilino
colatitude=co-latitude
colegatário=co-legatário
colicitante=co-licitante
colicitantes=co-licitantes
colitiga=co-litiga
colitigada=co-litigada
colitigadas=co-litigadas
colitigado=co-litigado
colitigados=co-litigados
colitigai=co-litigai
colitigais=co-litigais
colitigam=co-litigam
colitigamos=co-litigamos
colitigámos=co-litigámos
colitigando=co-litigando
colitigante=co-litigante
colitigantes=co-litigantes
colitigar=co-litigar
colitigara=co-litigara
colitigará=co-litigará
colitigaram=co-litigaram
colitigáramos=co-litigáramos
colitigarão=co-litigarão
colitigaras=co-litigaras
colitigarás=co-litigarás
colitigardes=co-litigardes
colitigarei=co-litigarei
colitigareis=co-litigareis
colitigáreis=co-litigáreis
colitigarem=co-litigarem
colitigaremos=co-litigaremos
colitigares=co-litigares
colitigaria=co-litigaria
colitigariam=co-litigariam
colitigaríamos=co-litigaríamos
colitigarias=co-litigarias
colitigaríeis=co-litigaríeis
colitigarmos=co-litigarmos
colitigas=co-litigas
colitigasse=co-litigasse
colitigásseis=co-litigásseis
colitigassem=co-litigassem
colitigássemos=co-litigássemos
colitigasses=co-litigasses
colitigaste=co-litigaste
colitigastes=co-litigastes
colitigava=co-litigava
colitigavam=co-litigavam
colitigávamos=co-litigávamos
colitigavas=co-litigavas
colitigáveis=co-litigáveis
colitigo=co-litigo
colitigou=co-litigou
colitigue=co-litigue
colitiguei=co-litiguei
colitigueis=co-litigueis
colitiguem=co-litiguem
colitiguemos=co-litiguemos
colitigues=co-litigues
cologaritmo=co-logaritmo
coocorrência=co-ocorrência
coocorrências=co-ocorrências
coocupante=co-ocupante
coocupantes=co-ocupantes
coopositor=co-opositor
coorientador=co-orientador
coorientadora=co-orientadora
coorientadoras=co-orientadoras
coorientadores=co-orientadores
coparceiro=co-parceiro
coparticipa=co-participa
coparticipada=co-participada
coparticipadas=co-participadas
coparticipado=co-participado
coparticipados=co-participados
coparticipai=co-participai
coparticipais=co-participais
coparticipam=co-participam
coparticipamos=co-participamos
coparticipámos=co-participámos
coparticipando=co-participando
coparticipante=co-participante
coparticipantes=co-participantes
coparticipar=co-participar
coparticipara=co-participara
coparticipará=co-participará
coparticiparam=co-participaram
coparticipáramos=co-participáramos
coparticiparão=co-participarão
coparticiparas=co-participaras
coparticiparás=co-participarás
coparticipardes=co-participardes
coparticiparei=co-participarei
coparticipareis=co-participareis
coparticipáreis=co-participáreis
coparticiparem=co-participarem
coparticiparemos=co-participaremos
coparticipares=co-participares
coparticiparia=co-participaria
coparticipariam=co-participariam
coparticiparíamos=co-participaríamos
coparticiparias=co-participarias
coparticiparíeis=co-participaríeis
coparticiparmos=co-participarmos
coparticipas=co-participas
coparticipasse=co-participasse
coparticipásseis=co-participásseis
coparticipassem=co-participassem
coparticipássemos=co-participássemos
coparticipasses=co-participasses
coparticipaste=co-participaste
coparticipastes=co-participastes
coparticipava=co-participava
coparticipavam=co-participavam
coparticipávamos=co-participávamos
coparticipavas=co-participavas
coparticipáveis=co-participáveis
coparticipe=co-participe
coparticipei=co-participei
coparticipeis=co-participeis
coparticipem=co-participem
coparticipemos=co-participemos
coparticipes=co-participes
coparticipo=co-participo
coparticipou=co-participou
coprodução=co-produção
coproduções=co-produções
copropriedade=co-propriedade
copropriedades=co-propriedades
coproprietário=co-proprietário
corredator=co-redactor
corredentor=co-redentor
correferência=co-referência
correferências=co-referências
corregência=co-regência
corregências=co-regências
corregente=co-regente
corresponsabiliza=co-responsabiliza
corresponsabilizada=co-responsabilizada
corresponsabilizadas=co-responsabilizadas
corresponsabilizado=co-responsabilizado
corresponsabilizados=co-responsabilizados
corresponsabilizai=co-responsabilizai
corresponsabilizais=co-responsabilizais
corresponsabilizam=co-responsabilizam
corresponsabilizamos=co-responsabilizamos
corresponsabilizámos=co-responsabilizámos
corresponsabilizando=co-responsabilizando
corresponsabilizar=co-responsabilizar
corresponsabilizara=co-responsabilizara
corresponsabilizará=co-responsabilizará
corresponsabilizaram=co-responsabilizaram
corresponsabilizáramos=co-responsabilizáramos
corresponsabilizarão=co-responsabilizarão
corresponsabilizaras=co-responsabilizaras
corresponsabilizarás=co-responsabilizarás
corresponsabilizardes=co-responsabilizardes
corresponsabilizarei=co-responsabilizarei
corresponsabilizareis=co-responsabilizareis
corresponsabilizáreis=co-responsabilizáreis
corresponsabilizarem=co-responsabilizarem
corresponsabilizaremos=co-responsabilizaremos
corresponsabilizares=co-responsabilizares
corresponsabilizaria=co-responsabilizaria
corresponsabilizariam=co-responsabilizariam
corresponsabilizaríamos=co-responsabilizaríamos
corresponsabilizarias=co-responsabilizarias
corresponsabilizaríeis=co-responsabilizaríeis
corresponsabilizarmos=co-responsabilizarmos
corresponsabilizas=co-responsabilizas
corresponsabilizasse=co-responsabilizasse
corresponsabilizásseis=co-responsabilizásseis
corresponsabilizassem=co-responsabilizassem
corresponsabilizássemos=co-responsabilizássemos
corresponsabilizasses=co-responsabilizasses
corresponsabilizaste=co-responsabilizaste
corresponsabilizastes=co-responsabilizastes
corresponsabilizava=co-responsabilizava
corresponsabilizavam=co-responsabilizavam
corresponsabilizávamos=co-responsabilizávamos
corresponsabilizavas=co-responsabilizavas
corresponsabilizáveis=co-responsabilizáveis
corresponsabilize=co-responsabilize
corresponsabilizei=co-responsabilizei
corresponsabilizeis=co-responsabilizeis
corresponsabilizem=co-responsabilizem
corresponsabilizemos=co-responsabilizemos
corresponsabilizes=co-responsabilizes
corresponsabilizo=co-responsabilizo
corresponsabilizou=co-responsabilizou
corresponsável=co-responsável
corréu=co-réu
cossecante=co-secante
cossecantes=co-secantes
cosseno=co-seno
cossignatário=co-signatário
cotangente=co-tangente
coação=coacção
coações=coacções
coatar=coactar
coatares=coactares
coátil=coáctil
coátis=coáctis
coativa=coactiva
coativamente=coactivamente
coativas=coactivas
coatividade=coactividade
coatividades=coactividades
coativo=coactivo
coativos=coactivos
coator=coactor
coatora=coactora
coatoras=coactoras
coatores=coactores
coartação=coarctação
coartações=coarctações
coartada=coarctada
coartadas=coarctadas
coartar=coarctar
coartares=coarctares
coartativo=coarctativo
coartativos=coarctativos
cofator=cofactor
cofatores=cofactores
coleção=colecção
coleciona=colecciona
colecionação=coleccionação
colecionações=coleccionações
colecionada=coleccionada
colecionadas=coleccionadas
colecionado=coleccionado
colecionador=coleccionador
colecionadora=coleccionadora
colecionadoras=coleccionadoras
colecionadores=coleccionadores
colecionados=coleccionados
colecionai=coleccionai
colecionais=coleccionais
colecionam=coleccionam
colecionamos=coleccionamos
colecionámos=coleccionámos
colecionando=coleccionando
colecionar=coleccionar
colecionara=coleccionara
colecionará=coleccionará
colecionaram=coleccionaram
colecionáramos=coleccionáramos
colecionarão=coleccionarão
colecionaras=coleccionaras
colecionarás=coleccionarás
colecionardes=coleccionardes
colecionarei=coleccionarei
colecionareis=coleccionareis
colecionáreis=coleccionáreis
colecionarem=coleccionarem
colecionaremos=coleccionaremos
colecionares=coleccionares
colecionaria=coleccionaria
colecionariam=coleccionariam
colecionaríamos=coleccionaríamos
colecionarias=coleccionarias
colecionaríeis=coleccionaríeis
colecionarmos=coleccionarmos
colecionas=coleccionas
colecionasse=coleccionasse
colecionásseis=coleccionásseis
colecionassem=coleccionassem
colecionássemos=coleccionássemos
colecionasses=coleccionasses
colecionaste=coleccionaste
colecionastes=coleccionastes
colecionava=coleccionava
colecionavam=coleccionavam
colecionávamos=coleccionávamos
colecionavas=coleccionavas
colecionáveis=coleccionáveis
colecionável=coleccionável
colecione=coleccione
colecionei=coleccionei
colecioneis=coleccioneis
colecionem=coleccionem
colecionemos=coleccionemos
coleciones=colecciones
colecionismo=coleccionismo
colecionismos=coleccionismos
colecionista=coleccionista
colecionistas=coleccionistas
colecionístico=coleccionístico
colecionísticos=coleccionísticos
coleciono=colecciono
colecionou=coleccionou
coleções=colecções
coleta=colecta
coletada=colectada
coletadas=colectadas
coletado=colectado
coletados=colectados
coletai=colectai
coletais=colectais
coletam=colectam
coletamos=colectamos
coletámos=colectámos
coletando=colectando
coletânea=colectânea
coletâneas=colectâneas
coletâneo=colectâneo
coletâneos=colectâneos
coletar=colectar
coletara=colectara
coletará=colectará
coletaram=colectaram
coletáramos=colectáramos
coletarão=colectarão
coletaras=colectaras
coletarás=colectarás
coletardes=colectardes
coletarei=colectarei
coletareis=colectareis
coletáreis=colectáreis
coletarem=colectarem
coletaremos=colectaremos
coletares=colectares
coletaria=colectaria
coletariam=colectariam
coletaríamos=colectaríamos
coletarias=colectarias
coletaríeis=colectaríeis
coletário=colectário
coletários=colectários
coletarmos=colectarmos
coletas=colectas
coletasse=colectasse
coletásseis=colectásseis
coletassem=colectassem
coletássemos=colectássemos
coletasses=colectasses
coletaste=colectaste
coletastes=colectastes
coletava=colectava
coletavam=colectavam
coletávamos=colectávamos
coletavas=colectavas
coletáveis=colectáveis
coletável=colectável
colete=colecte
coletei=colectei
coleteis=colecteis
coletem=colectem
coletemos=colectemos
coletes=colectes
coletício=colectício
coletícios=colectícios
coletiva=colectiva
coletivamente=colectivamente
coletivas=colectivas
coletividade=colectividade
coletividades=colectividades
coletivismo=colectivismo
coletivismos=colectivismos
coletivista=colectivista
coletivistas=colectivistas
coletivístico=colectivístico
coletivísticos=colectivísticos
coletivização=colectivização
coletivizações=colectivizações
coletivizar=colectivizar
coletivizares=colectivizares
coletivo=colectivo
coletivos=colectivos
coleto=colecto
coletor=colector
coletora=colectora
coletoras=colectoras
coletores=colectores
coletoria=colectoria
coletorias=colectorias
coletou=colectou
colopético=colopéctico
colopéticos=colopécticos
colorretite=colorrectite
colorretites=colorrectites
comprotetor=comprotector
comprotetores=comprotectores
conceção=concepção
concecionais=concepcionais
concecional=concepcional
concecionário=concepcionário
concecionários=concepcionários
conceções=concepções
concetaculífero=conceptaculífero
concetaculíferos=conceptaculíferos
concetáculo=conceptáculo
concetibilidade=conceptibilidade
concetibilidades=conceptibilidades
concetismo=conceptismo
concetismos=conceptismos
concetista=conceptista
concetível=conceptível
concetividade=conceptividade
concetividades=conceptividades
concetivo=conceptivo
concetivos=conceptivos
confeção=confecção
confeciona=confecciona
confecionada=confeccionada
confecionadas=confeccionadas
confecionado=confeccionado
confecionador=confeccionador
confecionadora=confeccionadora
confecionadoras=confeccionadoras
confecionadores=confeccionadores
confecionados=confeccionados
confecionai=confeccionai
confecionais=confeccionais
confecionam=confeccionam
confecionamos=confeccionamos
confecionámos=confeccionámos
confecionando=confeccionando
confecionar=confeccionar
confecionara=confeccionara
confecionará=confeccionará
confecionaram=confeccionaram
confecionáramos=confeccionáramos
confecionarão=confeccionarão
confecionaras=confeccionaras
confecionarás=confeccionarás
confecionardes=confeccionardes
confecionarei=confeccionarei
confecionareis=confeccionareis
confecionáreis=confeccionáreis
confecionarem=confeccionarem
confecionaremos=confeccionaremos
confecionares=confeccionares
confecionaria=confeccionaria
confecionariam=confeccionariam
confecionaríamos=confeccionaríamos
confecionarias=confeccionarias
confecionaríeis=confeccionaríeis
confecionarmos=confeccionarmos
confecionas=confeccionas
confecionasse=confeccionasse
confecionásseis=confeccionásseis
confecionassem=confeccionassem
confecionássemos=confeccionássemos
confecionasses=confeccionasses
confecionaste=confeccionaste
confecionastes=confeccionastes
confecionava=confeccionava
confecionavam=confeccionavam
confecionávamos=confeccionávamos
confecionavas=confeccionavas
confecionáveis=confeccionáveis
confecionável=confeccionável
confecione=confeccione
confecionei=confeccionei
confecioneis=confeccioneis
confecionem=confeccionem
confecionemos=confeccionemos
confeciones=confecciones
confeciono=confecciono
confecionou=confeccionou
confeções=confecções
conjetânea=conjectânea
conjetâneas=conjectâneas
conjetura=conjectura
conjeturabilidade=conjecturabilidade
conjeturabilidades=conjecturabilidades
conjeturada=conjecturada
conjeturadas=conjecturadas
conjeturado=conjecturado
conjeturador=conjecturador
conjeturadora=conjecturadora
conjeturadoras=conjecturadoras
conjeturadores=conjecturadores
conjeturados=conjecturados
conjeturai=conjecturai
conjeturais=conjecturais
conjetural=conjectural
conjeturalmente=conjecturalmente
conjeturam=conjecturam
conjeturamos=conjecturamos
conjeturámos=conjecturámos
conjeturando=conjecturando
conjeturante=conjecturante
conjeturantes=conjecturantes
conjeturar=conjecturar
conjeturara=conjecturara
conjeturará=conjecturará
conjeturaram=conjecturaram
conjeturáramos=conjecturáramos
conjeturarão=conjecturarão
conjeturaras=conjecturaras
conjeturarás=conjecturarás
conjeturardes=conjecturardes
conjeturarei=conjecturarei
conjeturareis=conjecturareis
conjeturáreis=conjecturáreis
conjeturarem=conjecturarem
conjeturaremos=conjecturaremos
conjeturares=conjecturares
conjeturaria=conjecturaria
conjeturariam=conjecturariam
conjeturaríamos=conjecturaríamos
conjeturarias=conjecturarias
conjeturaríeis=conjecturaríeis
conjeturarmos=conjecturarmos
conjeturas=conjecturas
conjeturasse=conjecturasse
conjeturásseis=conjecturásseis
conjeturassem=conjecturassem
conjeturássemos=conjecturássemos
conjeturasses=conjecturasses
conjeturaste=conjecturaste
conjeturastes=conjecturastes
conjeturava=conjecturava
conjeturavam=conjecturavam
conjeturávamos=conjecturávamos
conjeturavas=conjecturavas
conjeturáveis=conjecturáveis
conjeturável=conjecturável
conjeture=conjecture
conjeturei=conjecturei
conjetureis=conjectureis
conjeturem=conjecturem
conjeturemos=conjecturemos
conjetures=conjectures
conjeturista=conjecturista
conjeturistas=conjecturistas
conjeturo=conjecturo
conjeturou=conjecturou
conspeção=conspecção
conspeções=conspecções
contraespionagem=contra-espionagem
contraindica=contra-indica
contraindicação=contra-indicação
contraindicações=contra-indicações
contraindicada=contra-indicada
contraindicadas=contra-indicadas
contraindicado=contra-indicado
contraindicados=contra-indicados
contraindicai=contra-indicai
contraindicais=contra-indicais
contraindicam=contra-indicam
contraindicamos=contra-indicamos
contraindicámos=contra-indicámos
contraindicando=contra-indicando
contraindicar=contra-indicar
contraindicara=contra-indicara
contraindicará=contra-indicará
contraindicaram=contra-indicaram
contraindicáramos=contra-indicáramos
contraindicarão=contra-indicarão
contraindicaras=contra-indicaras
contraindicarás=contra-indicarás
contraindicardes=contra-indicardes
contraindicarei=contra-indicarei
contraindicareis=contra-indicareis
contraindicáreis=contra-indicáreis
contraindicarem=contra-indicarem
contraindicaremos=contra-indicaremos
contraindicares=contra-indicares
contraindicaria=contra-indicaria
contraindicariam=contra-indicariam
contraindicaríamos=contra-indicaríamos
contraindicarias=contra-indicarias
contraindicaríeis=contra-indicaríeis
contraindicarmos=contra-indicarmos
contraindicas=contra-indicas
contraindicasse=contra-indicasse
contraindicásseis=contra-indicásseis
contraindicassem=contra-indicassem
contraindicássemos=contra-indicássemos
contraindicasses=contra-indicasses
contraindicaste=contra-indicaste
contraindicastes=contra-indicastes
contraindicava=contra-indicava
contraindicavam=contra-indicavam
contraindicávamos=contra-indicávamos
contraindicavas=contra-indicavas
contraindicáveis=contra-indicáveis
contraindico=contra-indico
contraindicou=contra-indicou
contraindique=contra-indique
contraindiquei=contra-indiquei
contraindiqueis=contra-indiqueis
contraindiquem=contra-indiquem
contraindiquemos=contra-indiquemos
contraindiques=contra-indiques
contrainformação=contra-informação
contrainformações=contra-informações
contraofensiva=contra-ofensiva
contraofensivas=contra-ofensivas
contraordem=contra-ordem
contraordena=contra-ordena
contraordenação=contra-ordenação
contraordenações=contra-ordenações
contraordenada=contra-ordenada
contraordenadas=contra-ordenadas
contraordenado=contra-ordenado
contraordenados=contra-ordenados
contraordenai=contra-ordenai
contraordenais=contra-ordenais
contraordenam=contra-ordenam
contraordenamos=contra-ordenamos
contraordenámos=contra-ordenámos
contraordenando=contra-ordenando
contraordenar=contra-ordenar
contraordenara=contra-ordenara
contraordenará=contra-ordenará
contraordenaram=contra-ordenaram
contraordenáramos=contra-ordenáramos
contraordenarão=contra-ordenarão
contraordenaras=contra-ordenaras
contraordenarás=contra-ordenarás
contraordenardes=contra-ordenardes
contraordenarei=contra-ordenarei
contraordenareis=contra-ordenareis
contraordenáreis=contra-ordenáreis
contraordenarem=contra-ordenarem
contraordenaremos=contra-ordenaremos
contraordenares=contra-ordenares
contraordenaria=contra-ordenaria
contraordenariam=contra-ordenariam
contraordenaríamos=contra-ordenaríamos
contraordenarias=contra-ordenarias
contraordenaríeis=contra-ordenaríeis
contraordenarmos=contra-ordenarmos
contraordenas=contra-ordenas
contraordenasse=contra-ordenasse
contraordenásseis=contra-ordenásseis
contraordenassem=contra-ordenassem
contraordenássemos=contra-ordenássemos
contraordenasses=contra-ordenasses
contraordenaste=contra-ordenaste
contraordenastes=contra-ordenastes
contraordenava=contra-ordenava
contraordenavam=contra-ordenavam
contraordenávamos=contra-ordenávamos
contraordenavas=contra-ordenavas
contraordenáveis=contra-ordenáveis
contraordene=contra-ordene
contraordenei=contra-ordenei
contraordeneis=contra-ordeneis
contraordenem=contra-ordenem
contraordenemos=contra-ordenemos
contraordenes=contra-ordenes
contraordeno=contra-ordeno
contraordenou=contra-ordenou
contrarregra=contra-regra
contrarrelógio=contra-relógio
contrarrelógios=contra-relógios
contrarrevolta=contra-revolta
contrarrevolução=contra-revolução
contrarrevolucionário=contra-revolucionário
contrarrevoluções=contra-revoluções
contrassenha=contra-senha
contrassenso=contra-senso
contraterrorismo=contra-terrorismo
contração=contracção
contrações=contracções
contraceção=contracepção
contraceções=contracepções
contracetivo=contraceptivo
contracetivos=contraceptivos
contrativo=contractivo
contrafação=contrafacção
contrafações=contrafacções
contrafator=contrafactor
contrafatores=contrafactores
contraprojeto=contraprojecto
contraprojetos=contraprojectos
convetor=convector
convetores=convectores
correção=correcção
correcionais=correccionais
correcional=correccional
correcionalmente=correccionalmente
correções=correcções
correta=correcta
corretamente=correctamente
corretas=correctas
corretismo=correctismo
corretismos=correctismos
corretíssima=correctíssima
corretíssimas=correctíssimas
corretíssimo=correctíssimo
corretíssimos=correctíssimos
corretiva=correctiva
corretivamente=correctivamente
corretivas=correctivas
corretivo=correctivo
corretivos=correctivos
correto=correcto
corretor=corrector
corretora=correctora
corretoras=correctoras
corretores=correctores
corretoria=correctoria
corretorias=correctorias
corretório=correctório
corretórios=correctórios
corretos=correctos
corretriz=correctriz
corretrizs=correctrizs
correspetivo=correspectivo
correspetivos=correspectivos
creem=crêem
cristalelétrico=cristaleléctrico
cristalelétricos=cristaleléctricos
cutirreação=cutirreacção
cutirreações=cutirreacções
deadjetivais=deadjectivais
deadjetival=deadjectival
deceção=decepção
dececiona=decepciona
dececionada=decepcionada
dececionadas=decepcionadas
dececionado=decepcionado
dececionados=decepcionados
dececionai=decepcionai
dececionais=decepcionais
dececionam=decepcionam
dececionamos=decepcionamos
dececionámos=decepcionámos
dececionando=decepcionando
dececionante=decepcionante
dececionantes=decepcionantes
dececionar=decepcionar
dececionara=decepcionara
dececionará=decepcionará
dececionaram=decepcionaram
dececionáramos=decepcionáramos
dececionarão=decepcionarão
dececionaras=decepcionaras
dececionarás=decepcionarás
dececionardes=decepcionardes
dececionarei=decepcionarei
dececionareis=decepcionareis
dececionáreis=decepcionáreis
dececionarem=decepcionarem
dececionaremos=decepcionaremos
dececionares=decepcionares
dececionaria=decepcionaria
dececionariam=decepcionariam
dececionaríamos=decepcionaríamos
dececionarias=decepcionarias
dececionaríeis=decepcionaríeis
dececionarmos=decepcionarmos
dececionas=decepcionas
dececionasse=decepcionasse
dececionásseis=decepcionásseis
dececionassem=decepcionassem
dececionássemos=decepcionássemos
dececionasses=decepcionasses
dececionaste=decepcionaste
dececionastes=decepcionastes
dececionava=decepcionava
dececionavam=decepcionavam
dececionávamos=decepcionávamos
dececionavas=decepcionavas
dececionáveis=decepcionáveis
dececionável=decepcionável
dececione=decepcione
dececionei=decepcionei
dececioneis=decepcioneis
dececionem=decepcionem
dececionemos=decepcionemos
dececiones=decepciones
dececiono=decepciono
dececionou=decepcionou
deceções=decepções
decetivo=deceptivo
decetivos=deceptivos
deem=dêem
defeção=defecção
defeções=defecções
defetibilidade=defectibilidade
defetibilidades=defectibilidades
defetíveis=defectíveis
defetível=defectível
defetividade=defectividade
defetividades=defectividades
defetivo=defectivo
defetivos=defectivos
defetório=defectório
defetórios=defectórios
defetuoso=defectuoso
defetuosos=defectuosos
dejeção=dejecção
dejeções=dejecções
dejeta=dejecta
dejetada=dejectada
dejetadas=dejectadas
dejetado=dejectado
dejetados=dejectados
dejetai=dejectai
dejetais=dejectais
dejetam=dejectam
dejetamos=dejectamos
dejetámos=dejectámos
dejetando=dejectando
dejetar=dejectar
dejetara=dejectara
dejetará=dejectará
dejetaram=dejectaram
dejetáramos=dejectáramos
dejetarão=dejectarão
dejetaras=dejectaras
dejetarás=dejectarás
dejetardes=dejectardes
dejetarei=dejectarei
dejetareis=dejectareis
dejetáreis=dejectáreis
dejetarem=dejectarem
dejetaremos=dejectaremos
dejetares=dejectares
dejetaria=dejectaria
dejetariam=dejectariam
dejetaríamos=dejectaríamos
dejetarias=dejectarias
dejetaríeis=dejectaríeis
dejetarmos=dejectarmos
dejetas=dejectas
dejetasse=dejectasse
dejetásseis=dejectásseis
dejetassem=dejectassem
dejetássemos=dejectássemos
dejetasses=dejectasses
dejetaste=dejectaste
dejetastes=dejectastes
dejetava=dejectava
dejetavam=dejectavam
dejetávamos=dejectávamos
dejetavas=dejectavas
dejetáveis=dejectáveis
dejete=dejecte
dejetei=dejectei
dejeteis=dejecteis
dejetem=dejectem
dejetemos=dejectemos
dejetes=dejectes
dejeto=dejecto
dejetório=dejectório
dejetórios=dejectórios
dejetos=dejectos
dejetou=dejectou
dermoprotetor=dermoprotector
dermoprotetores=dermoprotectores
desativa=desactiva
desativação=desactivação
desativações=desactivações
desativada=desactivada
desativadas=desactivadas
desativado=desactivado
desativador=desactivador
desativadora=desactivadora
desativadoras=desactivadoras
desativadores=desactivadores
desativados=desactivados
desativai=desactivai
desativais=desactivais
desativam=desactivam
desativamos=desactivamos
desativámos=desactivámos
desativando=desactivando
desativante=desactivante
desativantes=desactivantes
desativar=desactivar
desativara=desactivara
desativará=desactivará
desativaram=desactivaram
desativáramos=desactiváramos
desativarão=desactivarão
desativaras=desactivaras
desativarás=desactivarás
desativardes=desactivardes
desativarei=desactivarei
desativareis=desactivareis
desativáreis=desactiváreis
desativarem=desactivarem
desativaremos=desactivaremos
desativares=desactivares
desativaria=desactivaria
desativariam=desactivariam
desativaríamos=desactivaríamos
desativarias=desactivarias
desativaríeis=desactivaríeis
desativarmos=desactivarmos
desativas=desactivas
desativasse=desactivasse
desativásseis=desactivásseis
desativassem=desactivassem
desativássemos=desactivássemos
desativasses=desactivasses
desativaste=desactivaste
desativastes=desactivastes
desativava=desactivava
desativavam=desactivavam
desativávamos=desactivávamos
desativavas=desactivavas
desativáveis=desactiváveis
desative=desactive
desativei=desactivei
desativeis=desactiveis
desativem=desactivem
desativemos=desactivemos
desatives=desactives
desativo=desactivo
desativou=desactivou
desatualização=desactualização
desatualizações=desactualizações
desatualizada=desactualizada
desatualizadas=desactualizadas
desatualizadíssima=desactualizadíssima
desatualizadíssimas=desactualizadíssimas
desatualizadíssimo=desactualizadíssimo
desatualizadíssimos=desactualizadíssimos
desatualizado=desactualizado
desatualizados=desactualizados
desatualizar=desactualizar
desatualizares=desactualizares
desafeta=desafecta
desafetação=desafectação
desafetações=desafectações
desafetada=desafectada
desafetadamente=desafectadamente
desafetadas=desafectadas
desafetado=desafectado
desafetados=desafectados
desafetai=desafectai
desafetais=desafectais
desafetam=desafectam
desafetamos=desafectamos
desafetámos=desafectámos
desafetando=desafectando
desafetante=desafectante
desafetantes=desafectantes
desafetar=desafectar
desafetara=desafectara
desafetará=desafectará
desafetaram=desafectaram
desafetáramos=desafectáramos
desafetarão=desafectarão
desafetaras=desafectaras
desafetarás=desafectarás
desafetardes=desafectardes
desafetarei=desafectarei
desafetareis=desafectareis
desafetáreis=desafectáreis
desafetarem=desafectarem
desafetaremos=desafectaremos
desafetares=desafectares
desafetaria=desafectaria
desafetariam=desafectariam
desafetaríamos=desafectaríamos
desafetarias=desafectarias
desafetaríeis=desafectaríeis
desafetarmos=desafectarmos
desafetas=desafectas
desafetasse=desafectasse
desafetásseis=desafectásseis
desafetassem=desafectassem
desafetássemos=desafectássemos
desafetasses=desafectasses
desafetaste=desafectaste
desafetastes=desafectastes
desafetava=desafectava
desafetavam=desafectavam
desafetávamos=desafectávamos
desafetavas=desafectavas
desafetáveis=desafectáveis
desafete=desafecte
desafetei=desafectei
desafeteis=desafecteis
desafetem=desafectem
desafetemos=desafectemos
desafetes=desafectes
desafeto=desafecto
desafetos=desafectos
desafetou=desafectou
desarquitetar=desarquitectar
desarquitetares=desarquitectares
desbatizar=desbaptizar
desbatizares=desbaptizares
descarateriza	# Dupla grafia=# descaracteriza
descaraterização	# Dupla grafia=# descaracterização
descaraterizações	# Dupla grafia=# descaracterizações
descaraterizada	# Dupla grafia=# descaracterizada
descaraterizadas	# Dupla grafia=# descaracterizadas
descaraterizado	# Dupla grafia=# descaracterizado
descaraterizador	# Dupla grafia=# descaracterizador
descaraterizadora	# Dupla grafia=# descaracterizadora
descaraterizadoras	# Dupla grafia=# descaracterizadoras
descaraterizadores	# Dupla grafia=# descaracterizadores
descaraterizados	# Dupla grafia=# descaracterizados
descaraterizai	# Dupla grafia=# descaracterizai
descaraterizais	# Dupla grafia=# descaracterizais
descaraterizam	# Dupla grafia=# descaracterizam
descaraterizamos	# Dupla grafia=# descaracterizamos
descaraterizámos	# Dupla grafia=# descaracterizámos
descaraterizando	# Dupla grafia=# descaracterizando
descaraterizante	# Dupla grafia=# descaracterizante
descaraterizantes	# Dupla grafia=# descaracterizantes
descaraterizar	# Dupla grafia=# descaracterizar
descaraterizara	# Dupla grafia=# descaracterizara
descaraterizará	# Dupla grafia=# descaracterizará
descaraterizaram	# Dupla grafia=# descaracterizaram
descaraterizáramos	# Dupla grafia=# descaracterizáramos
descaraterizarão	# Dupla grafia=# descaracterizarão
descaraterizaras	# Dupla grafia=# descaracterizaras
descaraterizarás	# Dupla grafia=# descaracterizarás
descaraterizardes	# Dupla grafia=# descaracterizardes
descaraterizarei	# Dupla grafia=# descaracterizarei
descaraterizareis	# Dupla grafia=# descaracterizareis
descaraterizáreis	# Dupla grafia=# descaracterizáreis
descaraterizarem	# Dupla grafia=# descaracterizarem
descaraterizaremos	# Dupla grafia=# descaracterizaremos
descaraterizares	# Dupla grafia=# descaracterizares
descaraterizaria	# Dupla grafia=# descaracterizaria
descaraterizariam	# Dupla grafia=# descaracterizariam
descaraterizaríamos	# Dupla grafia=# descaracterizaríamos
descaraterizarias	# Dupla grafia=# descaracterizarias
descaraterizaríeis	# Dupla grafia=# descaracterizaríeis
descaraterizarmos	# Dupla grafia=# descaracterizarmos
descaraterizas	# Dupla grafia=# descaracterizas
descaraterizasse	# Dupla grafia=# descaracterizasse
descaraterizásseis	# Dupla grafia=# descaracterizásseis
descaraterizassem	# Dupla grafia=# descaracterizassem
descaraterizássemos	# Dupla grafia=# descaracterizássemos
descaraterizasses	# Dupla grafia=# descaracterizasses
descaraterizaste	# Dupla grafia=# descaracterizaste
descaraterizastes	# Dupla grafia=# descaracterizastes
descaraterizava	# Dupla grafia=# descaracterizava
descaraterizavam	# Dupla grafia=# descaracterizavam
descaraterizávamos	# Dupla grafia=# descaracterizávamos
descaraterizavas	# Dupla grafia=# descaracterizavas
descaraterizáveis	# Dupla grafia=# descaracterizáveis
descaraterize	# Dupla grafia=# descaracterize
descaraterizei	# Dupla grafia=# descaracterizei
descaraterizeis	# Dupla grafia=# descaracterizeis
descaraterizem	# Dupla grafia=# descaracterizem
descaraterizemos	# Dupla grafia=# descaracterizemos
descaraterizes	# Dupla grafia=# descaracterizes
descaraterizo	# Dupla grafia=# descaracterizo
descaraterizou	# Dupla grafia=# descaracterizou
descontração=descontracção
descontrações=descontracções
deseletrizar=deselectrizar
deseletrizares=deselectrizares
deseletrizáveis=deselectrizáveis
deseletrizável=deselectrizável
desinfeção=desinfecção
desinfeciona=desinfecciona
desinfecionada=desinfeccionada
desinfecionadas=desinfeccionadas
desinfecionado=desinfeccionado
desinfecionados=desinfeccionados
desinfecionai=desinfeccionai
desinfecionais=desinfeccionais
desinfecionam=desinfeccionam
desinfecionamos=desinfeccionamos
desinfecionámos=desinfeccionámos
desinfecionando=desinfeccionando
desinfecionar=desinfeccionar
desinfecionara=desinfeccionara
desinfecionará=desinfeccionará
desinfecionaram=desinfeccionaram
desinfecionáramos=desinfeccionáramos
desinfecionarão=desinfeccionarão
desinfecionaras=desinfeccionaras
desinfecionarás=desinfeccionarás
desinfecionardes=desinfeccionardes
desinfecionarei=desinfeccionarei
desinfecionareis=desinfeccionareis
desinfecionáreis=desinfeccionáreis
desinfecionarem=desinfeccionarem
desinfecionaremos=desinfeccionaremos
desinfecionares=desinfeccionares
desinfecionaria=desinfeccionaria
desinfecionariam=desinfeccionariam
desinfecionaríamos=desinfeccionaríamos
desinfecionarias=desinfeccionarias
desinfecionaríeis=desinfeccionaríeis
desinfecionarmos=desinfeccionarmos
desinfecionas=desinfeccionas
desinfecionasse=desinfeccionasse
desinfecionásseis=desinfeccionásseis
desinfecionassem=desinfeccionassem
desinfecionássemos=desinfeccionássemos
desinfecionasses=desinfeccionasses
desinfecionaste=desinfeccionaste
desinfecionastes=desinfeccionastes
desinfecionava=desinfeccionava
desinfecionavam=desinfeccionavam
desinfecionávamos=desinfeccionávamos
desinfecionavas=desinfeccionavas
desinfecionáveis=desinfeccionáveis
desinfecione=desinfeccione
desinfecionei=desinfeccionei
desinfecioneis=desinfeccioneis
desinfecionem=desinfeccionem
desinfecionemos=desinfeccionemos
desinfeciones=desinfecciones
desinfeciono=desinfecciono
desinfecionou=desinfeccionou
desinfeções=desinfecções
desinfeta=desinfecta
desinfetada=desinfectada
desinfetadas=desinfectadas
desinfetado=desinfectado
desinfetador=desinfectador
desinfetadora=desinfectadora
desinfetadoras=desinfectadoras
desinfetadores=desinfectadores
desinfetados=desinfectados
desinfetai=desinfectai
desinfetais=desinfectais
desinfetam=desinfectam
desinfetamos=desinfectamos
desinfetámos=desinfectámos
desinfetando=desinfectando
desinfetante=desinfectante
desinfetantes=desinfectantes
desinfetar=desinfectar
desinfetara=desinfectara
desinfetará=desinfectará
desinfetaram=desinfectaram
desinfetáramos=desinfectáramos
desinfetarão=desinfectarão
desinfetaras=desinfectaras
desinfetarás=desinfectarás
desinfetardes=desinfectardes
desinfetarei=desinfectarei
desinfetareis=desinfectareis
desinfetáreis=desinfectáreis
desinfetarem=desinfectarem
desinfetaremos=desinfectaremos
desinfetares=desinfectares
desinfetaria=desinfectaria
desinfetariam=desinfectariam
desinfetaríamos=desinfectaríamos
desinfetarias=desinfectarias
desinfetaríeis=desinfectaríeis
desinfetarmos=desinfectarmos
desinfetas=desinfectas
desinfetasse=desinfectasse
desinfetásseis=desinfectásseis
desinfetassem=desinfectassem
desinfetássemos=desinfectássemos
desinfetasses=desinfectasses
desinfetaste=desinfectaste
desinfetastes=desinfectastes
desinfetava=desinfectava
desinfetavam=desinfectavam
desinfetávamos=desinfectávamos
desinfetavas=desinfectavas
desinfetáveis=desinfectáveis
desinfetável=desinfectável
desinfete=desinfecte
desinfetei=desinfectei
desinfeteis=desinfecteis
desinfetem=desinfectem
desinfetemos=desinfectemos
desinfetes=desinfectes
desinfeto=desinfecto
desinfetório=desinfectório
desinfetórios=desinfectórios
desinfetou=desinfectou
desmorrético=desmorréctico
desmorréticos=desmorrécticos
desproteção=desprotecção
desproteções=desprotecções
desseleciona=desselecciona
desselecionada=desseleccionada
desselecionadas=desseleccionadas
desselecionado=desseleccionado
desselecionados=desseleccionados
desselecionai=desseleccionai
desselecionais=desseleccionais
desselecionam=desseleccionam
desselecionamos=desseleccionamos
desselecionámos=desseleccionámos
desselecionando=desseleccionando
desselecionar=desseleccionar
desselecionara=desseleccionara
desselecionará=desseleccionará
desselecionaram=desseleccionaram
desselecionáramos=desseleccionáramos
desselecionarão=desseleccionarão
desselecionaras=desseleccionaras
desselecionarás=desseleccionarás
desselecionardes=desseleccionardes
desselecionarei=desseleccionarei
desselecionareis=desseleccionareis
desselecionáreis=desseleccionáreis
desselecionarem=desseleccionarem
desselecionaremos=desseleccionaremos
desselecionares=desseleccionares
desselecionaria=desseleccionaria
desselecionariam=desseleccionariam
desselecionaríamos=desseleccionaríamos
desselecionarias=desseleccionarias
desselecionaríeis=desseleccionaríeis
desselecionarmos=desseleccionarmos
desselecionas=desseleccionas
desselecionasse=desseleccionasse
desselecionásseis=desseleccionásseis
desselecionassem=desseleccionassem
desselecionássemos=desseleccionássemos
desselecionasses=desseleccionasses
desselecionaste=desseleccionaste
desselecionastes=desseleccionastes
desselecionava=desseleccionava
desselecionavam=desseleccionavam
desselecionávamos=desseleccionávamos
desselecionavas=desseleccionavas
desselecionáveis=desseleccionáveis
desselecione=desseleccione
desselecionei=desseleccionei
desselecioneis=desseleccioneis
desselecionem=desseleccionem
desselecionemos=desseleccionemos
desseleciones=desselecciones
desseleciono=desselecciono
desselecionou=desseleccionou
deteção=detecção
deteções=detecções
deteta=detecta
detetabilidade=detectabilidade
detetabilidades=detectabilidades
detetada=detectada
detetadas=detectadas
detetado=detectado
detetados=detectados
detetai=detectai
detetais=detectais
detetam=detectam
detetamos=detectamos
detetámos=detectámos
detetando=detectando
detetar=detectar
detetara=detectara
detetará=detectará
detetaram=detectaram
detetáramos=detectáramos
detetarão=detectarão
detetaras=detectaras
detetarás=detectarás
detetardes=detectardes
detetarei=detectarei
detetareis=detectareis
detetáreis=detectáreis
detetarem=detectarem
detetaremos=detectaremos
detetares=detectares
detetaria=detectaria
detetariam=detectariam
detetaríamos=detectaríamos
detetarias=detectarias
detetaríeis=detectaríeis
detetarmos=detectarmos
detetas=detectas
detetasse=detectasse
detetásseis=detectásseis
detetassem=detectassem
detetássemos=detectássemos
detetasses=detectasses
detetaste=detectaste
detetastes=detectastes
detetava=detectava
detetavam=detectavam
detetávamos=detectávamos
detetavas=detectavas
detetáveis=detectáveis
detetável=detectável
detete=detecte
detetei=detectei
deteteis=detecteis
detetem=detectem
detetemos=detectemos
detetes=detectes
detetiva=detectiva
detetivas=detectivas
detetive=detective
detetives=detectives
deteto=detecto
detetor=detector
detetores=detectores
detetou=detectou
detração=detracção
detrações=detracções
detrativo=detractivo
detrativos=detractivos
detrator=detractor
detratora=detractora
detratoras=detractoras
detratores=detractores
dialetais=dialectais
dialetal=dialectal
dialetalmente=dialectalmente
dialética=dialéctica
dialeticamente=dialecticamente
dialéticas=dialécticas
dialético=dialéctico
dialéticos=dialécticos
dialetismo=dialectismo
dialetismos=dialectismos
dialetista=dialectista
dialetistas=dialectistas
dialetização=dialectização
dialetizações=dialectizações
dialetizar=dialectizar
dialetizares=dialectizares
dialeto=dialecto
dialetóloga=dialectóloga
dialetólogas=dialectólogas
dialetologia=dialectologia
dialetologias=dialectologias
dialetológica=dialectológica
dialetológicas=dialectológicas
dialetológico=dialectológico
dialetológicos=dialectológicos
dialetologista=dialectologista
dialetologistas=dialectologistas
dialetólogo=dialectólogo
dialetólogos=dialectólogos
dialetos=dialectos
dicatalético=dicataléctico
dicataléticos=dicatalécticos
didata=didacta
didatas=didactas
didática=didáctica
didaticamente=didacticamente
didáticas=didácticas
didático=didáctico
didáticos=didácticos
didatismo=didactismo
didatismos=didactismos
dielétrica=dieléctrica
dielétricas=dieléctricas
dieletricidade=dielectricidade
dieletricidades=dielectricidades
dielétrico=dieléctrico
dielétricos=dieléctricos
difração=difracção
difrações=difracções
difrata=difracta
difratada=difractada
difratadas=difractadas
difratado=difractado
difratados=difractados
difratai=difractai
difratais=difractais
difratam=difractam
difratamos=difractamos
difratámos=difractámos
difratando=difractando
difratar=difractar
difratara=difractara
difratará=difractará
difrataram=difractaram
difratáramos=difractáramos
difratarão=difractarão
difrataras=difractaras
difratarás=difractarás
difratardes=difractardes
difratarei=difractarei
difratareis=difractareis
difratáreis=difractáreis
difratarem=difractarem
difrataremos=difractaremos
difratares=difractares
difrataria=difractaria
difratariam=difractariam
difrataríamos=difractaríamos
difratarias=difractarias
difrataríeis=difractaríeis
difratarmos=difractarmos
difratas=difractas
difratasse=difractasse
difratásseis=difractásseis
difratassem=difractassem
difratássemos=difractássemos
difratasses=difractasses
difrataste=difractaste
difratastes=difractastes
difratava=difractava
difratavam=difractavam
difratávamos=difractávamos
difratavas=difractavas
difratáveis=difractáveis
difrate=difracte
difratei=difractei
difrateis=difracteis
difratem=difractem
difratemos=difractemos
difrates=difractes
difrativo=difractivo
difrativos=difractivos
difrato=difracto
difratou=difractou
dileção=dilecção
dileções=dilecções
dileto=dilecto
diletos=dilectos
dinamoelétrico=dinamoeléctrico
dinamoelétricos=dinamoeléctricos
Direção-Geral=Direcção-Geral
direção=direcção
direciona=direcciona
direcionabilidade=direccionabilidade
direcionabilidades=direccionabilidades
direcionada=direccionada
direcionadas=direccionadas
direcionado=direccionado
direcionados=direccionados
direcionai=direccionai
direcionais=direccionais
direcional=direccional
direcionam=direccionam
direcionamento=direccionamento
direcionamentos=direccionamentos
direcionamos=direccionamos
direcionámos=direccionámos
direcionando=direccionando
direcionar=direccionar
direcionara=direccionara
direcionará=direccionará
direcionaram=direccionaram
direcionáramos=direccionáramos
direcionarão=direccionarão
direcionaras=direccionaras
direcionarás=direccionarás
direcionardes=direccionardes
direcionarei=direccionarei
direcionareis=direccionareis
direcionáreis=direccionáreis
direcionarem=direccionarem
direcionaremos=direccionaremos
direcionares=direccionares
direcionaria=direccionaria
direcionariam=direccionariam
direcionaríamos=direccionaríamos
direcionarias=direccionarias
direcionaríeis=direccionaríeis
direcionarmos=direccionarmos
direcionas=direccionas
direcionasse=direccionasse
direcionásseis=direccionásseis
direcionassem=direccionassem
direcionássemos=direccionássemos
direcionasses=direccionasses
direcionaste=direccionaste
direcionastes=direccionastes
direcionava=direccionava
direcionavam=direccionavam
direcionávamos=direccionávamos
direcionavas=direccionavas
direcionáveis=direccionáveis
direcionável=direccionável
direcione=direccione
direcionei=direccionei
direcioneis=direccioneis
direcionem=direccionem
direcionemos=direccionemos
direciones=direcciones
direciono=direcciono
direcionou=direccionou
direções=direcções
direta=directa
diretamente=directamente
diretas=directas
diretiva=directiva
diretivas=directivas
diretivo=directivo
diretivos=directivos
direto=directo
diretor-geral=director-geral
diretor=director
diretora=directora
diretorado=directorado
diretorados=directorados
diretorais=directorais
diretoral=directoral
diretoras=directoras
diretores=directores
diretoria=directoria
diretoriais=directoriais
diretorial=directorial
diretorias=directorias
diretório=directório
diretórios=directórios
diretos=directos
diretriz=directriz
diretrizes=directrizes
diretrizs=directrizs
dislético=disléctico
disléticos=dislécticos
disorético=disoréctico
disoréticos=disorécticos
dissetor=dissector
distático=distáctico
distáticos=distácticos
distração=distracção
distrações=distracções
distrátil=distráctil
distrátis=distráctis
distrativo=distractivo
distrativos=distractivos
ecfrático=ecfráctico
ecfráticos=ecfrácticos
eclética=ecléctica
ecleticamente=eclecticamente
ecléticas=eclécticas
ecleticismo=eclecticismo
ecleticismos=eclecticismos
eclético=ecléctico
ecléticos=eclécticos
ecletismo=eclectismo
ecletismos=eclectismos
eclítica=eclíptica
eclíticas=eclípticas
eclítico=eclíptico
eclíticos=eclípticos
editais=edictais
edital=edictal
edito=edicto
editos=edictos
efetiva=efectiva
efetivação=efectivação
efetivações=efectivações
efetivada=efectivada
efetivadas=efectivadas
efetivado=efectivado
efetivador=efectivador
efetivadores=efectivadores
efetivados=efectivados
efetivai=efectivai
efetivais=efectivais
efetivam=efectivam
efetivamente=efectivamente
efetivamos=efectivamos
efetivámos=efectivámos
efetivando=efectivando
efetivar=efectivar
efetivara=efectivara
efetivará=efectivará
efetivaram=efectivaram
efetiváramos=efectiváramos
efetivarão=efectivarão
efetivaras=efectivaras
efetivarás=efectivarás
efetivardes=efectivardes
efetivarei=efectivarei
efetivareis=efectivareis
efetiváreis=efectiváreis
efetivarem=efectivarem
efetivaremos=efectivaremos
efetivares=efectivares
efetivaria=efectivaria
efetivariam=efectivariam
efetivaríamos=efectivaríamos
efetivarias=efectivarias
efetivaríeis=efectivaríeis
efetivarmos=efectivarmos
efetivas=efectivas
efetivasse=efectivasse
efetivásseis=efectivásseis
efetivassem=efectivassem
efetivássemos=efectivássemos
efetivasses=efectivasses
efetivaste=efectivaste
efetivastes=efectivastes
efetivava=efectivava
efetivavam=efectivavam
efetivávamos=efectivávamos
efetivavas=efectivavas
efetiváveis=efectiváveis
efetivável=efectivável
efetive=efective
efetivei=efectivei
efetiveis=efectiveis
efetíveis=efectíveis
efetível=efectível
efetivem=efectivem
efetivemos=efectivemos
efetives=efectives
efetividade=efectividade
efetividades=efectividades
efetivo=efectivo
efetivos=efectivos
efetivou=efectivou
efetua=efectua
efetuação=efectuação
efetuações=efectuações
efetuada=efectuada
efetuadas=efectuadas
efetuado=efectuado
efetuador=efectuador
efetuadora=efectuadora
efetuadoras=efectuadoras
efetuadores=efectuadores
efetuados=efectuados
efetuai=efectuai
efetuais=efectuais
efetuam=efectuam
efetuamos=efectuamos
efetuámos=efectuámos
efetuando=efectuando
efetuar=efectuar
efetuara=efectuara
efetuará=efectuará
efetuaram=efectuaram
efetuáramos=efectuáramos
efetuarão=efectuarão
efetuaras=efectuaras
efetuarás=efectuarás
efetuardes=efectuardes
efetuarei=efectuarei
efetuareis=efectuareis
efetuáreis=efectuáreis
efetuarem=efectuarem
efetuaremos=efectuaremos
efetuares=efectuares
efetuaria=efectuaria
efetuariam=efectuariam
efetuaríamos=efectuaríamos
efetuarias=efectuarias
efetuaríeis=efectuaríeis
efetuarmos=efectuarmos
efetuas=efectuas
efetuasse=efectuasse
efetuásseis=efectuásseis
efetuassem=efectuassem
efetuássemos=efectuássemos
efetuasses=efectuasses
efetuaste=efectuaste
efetuastes=efectuastes
efetuava=efectuava
efetuavam=efectuavam
efetuávamos=efectuávamos
efetuavas=efectuavas
efetuáveis=efectuáveis
efetuável=efectuável
efetue=efectue
efetuei=efectuei
efetueis=efectueis
efetuem=efectuem
efetuemos=efectuemos
efetues=efectues
efetuo=efectuo
efetuoso=efectuoso
efetuosos=efectuosos
efetuou=efectuou
efração=efracção
efrações=efracções
efratura=efractura
efraturas=efracturas
ejeção=ejecção
ejeções=ejecções
ejeta=ejecta
ejetada=ejectada
ejetadas=ejectadas
ejetado=ejectado
ejetados=ejectados
ejetai=ejectai
ejetais=ejectais
ejetam=ejectam
ejetamos=ejectamos
ejetámos=ejectámos
ejetando=ejectando
ejetar=ejectar
ejetara=ejectara
ejetará=ejectará
ejetaram=ejectaram
ejetáramos=ejectáramos
ejetarão=ejectarão
ejetaras=ejectaras
ejetarás=ejectarás
ejetardes=ejectardes
ejetarei=ejectarei
ejetareis=ejectareis
ejetáreis=ejectáreis
ejetarem=ejectarem
ejetaremos=ejectaremos
ejetares=ejectares
ejetaria=ejectaria
ejetariam=ejectariam
ejetaríamos=ejectaríamos
ejetarias=ejectarias
ejetaríeis=ejectaríeis
ejetarmos=ejectarmos
ejetas=ejectas
ejetasse=ejectasse
ejetásseis=ejectásseis
ejetassem=ejectassem
ejetássemos=ejectássemos
ejetasses=ejectasses
ejetaste=ejectaste
ejetastes=ejectastes
ejetava=ejectava
ejetavam=ejectavam
ejetávamos=ejectávamos
ejetavas=ejectavas
ejetáveis=ejectáveis
ejetável=ejectável
ejete=ejecte
ejetei=ejectei
ejeteis=ejecteis
ejetem=ejectem
ejetemos=ejectemos
ejetes=ejectes
ejeto=ejecto
ejetólito=ejectólito
ejetólitos=ejectólitos
ejetor=ejector
ejetores=ejectores
ejetou=ejectou
eletiva=electiva
eletivamente=electivamente
eletivas=electivas
eletividade=electividade
eletividades=electividades
eletivo=electivo
eletivos=electivos
eletracústica=electracústica
eletracústicas=electracústicas
eletrão-volt=electrão-volt
eletrão=electrão
eletrargois=electrargois
eletrargol=electrargol
eletrencefalografia=electrencefalografia
eletrencefalografias=electrencefalografias
eletrencefalográfico=electrencefalográfico
eletrencefalográficos=electrencefalográficos
eletrencefalograma=electrencefalograma
eletrencefalogramas=electrencefalogramas
eletrete=electrete
eletretes=electretes
eletrexecução=electrexecução
eletrexecuções=electrexecuções
elétrica=eléctrica
eletricamente=electricamente
elétricas=eléctricas
eletricidade=electricidade
eletricidades=electricidades
eletricismo=electricismo
eletricismos=electricismos
eletricista=electricista
eletricistas=electricistas
elétrico=eléctrico
elétricos=eléctricos
eletrifica=electrifica
eletrificação=electrificação
eletrificações=electrificações
eletrificada=electrificada
eletrificadas=electrificadas
eletrificado=electrificado
eletrificador=electrificador
eletrificadores=electrificadores
eletrificados=electrificados
eletrificai=electrificai
eletrificais=electrificais
eletrificam=electrificam
eletrificamos=electrificamos
eletrificámos=electrificámos
eletrificando=electrificando
eletrificar=electrificar
eletrificara=electrificara
eletrificará=electrificará
eletrificaram=electrificaram
eletrificáramos=electrificáramos
eletrificarão=electrificarão
eletrificaras=electrificaras
eletrificarás=electrificarás
eletrificardes=electrificardes
eletrificarei=electrificarei
eletrificareis=electrificareis
eletrificáreis=electrificáreis
eletrificarem=electrificarem
eletrificaremos=electrificaremos
eletrificares=electrificares
eletrificaria=electrificaria
eletrificariam=electrificariam
eletrificaríamos=electrificaríamos
eletrificarias=electrificarias
eletrificaríeis=electrificaríeis
eletrificarmos=electrificarmos
eletrificas=electrificas
eletrificasse=electrificasse
eletrificásseis=electrificásseis
eletrificassem=electrificassem
eletrificássemos=electrificássemos
eletrificasses=electrificasses
eletrificaste=electrificaste
eletrificastes=electrificastes
eletrificava=electrificava
eletrificavam=electrificavam
eletrificávamos=electrificávamos
eletrificavas=electrificavas
eletrificáveis=electrificáveis
eletrificável=electrificável
eletrifico=electrifico
eletrificou=electrificou
eletrifique=electrifique
eletrifiquei=electrifiquei
eletrifiqueis=electrifiqueis
eletrifiquem=electrifiquem
eletrifiquemos=electrifiquemos
eletrifiques=electrifiques
eletríman=electríman
eletrímans=electrímans
elétrino=eléctrino
elétrinos=eléctrinos
eletriza=electriza
eletrização=electrização
eletrizações=electrizações
eletrizada=electrizada
eletrizadas=electrizadas
eletrizado=electrizado
eletrizador=electrizador
eletrizadora=electrizadora
eletrizadoras=electrizadoras
eletrizadores=electrizadores
eletrizados=electrizados
eletrizai=electrizai
eletrizais=electrizais
eletrizam=electrizam
eletrizamos=electrizamos
eletrizámos=electrizámos
eletrizando=electrizando
eletrizante=electrizante
eletrizantes=electrizantes
eletrizar=electrizar
eletrizara=electrizara
eletrizará=electrizará
eletrizaram=electrizaram
eletrizáramos=electrizáramos
eletrizarão=electrizarão
eletrizaras=electrizaras
eletrizarás=electrizarás
eletrizardes=electrizardes
eletrizarei=electrizarei
eletrizareis=electrizareis
eletrizáreis=electrizáreis
eletrizarem=electrizarem
eletrizaremos=electrizaremos
eletrizares=electrizares
eletrizaria=electrizaria
eletrizariam=electrizariam
eletrizaríamos=electrizaríamos
eletrizarias=electrizarias
eletrizaríeis=electrizaríeis
eletrizarmos=electrizarmos
eletrizas=electrizas
eletrizasse=electrizasse
eletrizásseis=electrizásseis
eletrizassem=electrizassem
eletrizássemos=electrizássemos
eletrizasses=electrizasses
eletrizaste=electrizaste
eletrizastes=electrizastes
eletrizava=electrizava
eletrizavam=electrizavam
eletrizávamos=electrizávamos
eletrizavas=electrizavas
eletrizáveis=electrizáveis
eletrizável=electrizável
eletrize=electrize
eletrizei=electrizei
eletrizeis=electrizeis
eletrizem=electrizem
eletrizemos=electrizemos
eletrizes=electrizes
eletrizo=electrizo
eletrizou=electrizou
eletroacústico=electroacústico
eletroacústicos=electroacústicos
eletrobalística=electrobalística
eletrobalísticas=electrobalísticas
eletrobiologia=electrobiologia
eletrobiologias=electrobiologias
eletrobiológico=electrobiológico
eletrobiológicos=electrobiológicos
eletrobomba=electrobomba
eletrobombas=electrobombas
eletrocardiografia=electrocardiografia
eletrocardiografias=electrocardiografias
eletrocardiográfico=electrocardiográfico
eletrocardiográficos=electrocardiográficos
eletrocardiógrafo=electrocardiógrafo
eletrocardiógrafos=electrocardiógrafos
eletrocardiograma=electrocardiograma
eletrocardiogramas=electrocardiogramas
eletrochoque=electrochoque
eletrochoques=electrochoques
eletrocinética=electrocinética
eletrocinéticas=electrocinéticas
eletrocinético=electrocinético
eletrocinéticos=electrocinéticos
eletrocirurgia=electrocirurgia
eletrocirurgias=electrocirurgias
eletrocoagulação=electrocoagulação
eletrocoagulações=electrocoagulações
eletrocultura=electrocultura
eletroculturas=electroculturas
eletrocussão=electrocussão
eletrocussões=electrocussões
eletrocuta=electrocuta
eletrocutada=electrocutada
eletrocutadas=electrocutadas
eletrocutado=electrocutado
eletrocutados=electrocutados
eletrocutai=electrocutai
eletrocutais=electrocutais
eletrocutam=electrocutam
eletrocutamos=electrocutamos
eletrocutámos=electrocutámos
eletrocutando=electrocutando
eletrocutar=electrocutar
eletrocutara=electrocutara
eletrocutará=electrocutará
eletrocutaram=electrocutaram
eletrocutáramos=electrocutáramos
eletrocutarão=electrocutarão
eletrocutaras=electrocutaras
eletrocutarás=electrocutarás
eletrocutardes=electrocutardes
eletrocutarei=electrocutarei
eletrocutareis=electrocutareis
eletrocutáreis=electrocutáreis
eletrocutarem=electrocutarem
eletrocutaremos=electrocutaremos
eletrocutares=electrocutares
eletrocutaria=electrocutaria
eletrocutariam=electrocutariam
eletrocutaríamos=electrocutaríamos
eletrocutarias=electrocutarias
eletrocutaríeis=electrocutaríeis
eletrocutarmos=electrocutarmos
eletrocutas=electrocutas
eletrocutasse=electrocutasse
eletrocutásseis=electrocutásseis
eletrocutassem=electrocutassem
eletrocutássemos=electrocutássemos
eletrocutasses=electrocutasses
eletrocutaste=electrocutaste
eletrocutastes=electrocutastes
eletrocutava=electrocutava
eletrocutavam=electrocutavam
eletrocutávamos=electrocutávamos
eletrocutavas=electrocutavas
eletrocutáveis=electrocutáveis
eletrocute=electrocute
eletrocutei=electrocutei
eletrocuteis=electrocuteis
eletrocutem=electrocutem
eletrocutemos=electrocutemos
eletrocutes=electrocutes
eletrocutir=electrocutir
eletrocutires=electrocutires
eletrocuto=electrocuto
eletrocutor=electrocutor
eletrocutores=electrocutores
eletrocutou=electrocutou
eletrodeposição=electrodeposição
eletrodeposições=electrodeposições
eletrodiagnóstico=electrodiagnóstico
eletrodiagnósticos=electrodiagnósticos
eletrodiálise=electrodiálise
eletrodiálises=electrodiálises
eletrodinâmica=electrodinâmica
eletrodinâmicas=electrodinâmicas
eletrodinâmico=electrodinâmico
eletrodinâmicos=electrodinâmicos
eletrodinamismo=electrodinamismo
eletrodinamismos=electrodinamismos
eletrodinamómetro=electrodinamómetro
eletrodinamómetros=electrodinamómetros
eletródio=electródio
eletródios=electródios
elétrodo=eléctrodo
eletrodoméstico=electrodoméstico
eletrodomésticos=electrodomésticos
elétrodos=eléctrodos
eletroencefalografia=electroencefalografia
eletroencefalografias=electroencefalografias
eletroencefalográfico=electroencefalográfico
eletroencefalográficos=electroencefalográficos
eletroencefalógrafo=electroencefalógrafo
eletroencefalógrafos=electroencefalógrafos
eletroencefalograma=electroencefalograma
eletroencefalogramas=electroencefalogramas
eletrões=electrões
eletrófilo=electrófilo
eletrófilos=electrófilos
eletrofisiologia=electrofisiologia
eletrofisiologias=electrofisiologias
eletrofisiológico=electrofisiológico
eletrofisiológicos=electrofisiológicos
eletrofone=electrofone
eletrofones=electrofones
eletroforese=electroforese
eletroforeses=electroforeses
eletroformação=electroformação
eletroformações=electroformações
eletróforo=electróforo
eletróforos=electróforos
eletrofotografia=electrofotografia
eletrofotografias=electrofotografias
eletrofotográfico=electrofotográfico
eletrofotográficos=electrofotográficos
eletrogalvânico=electrogalvânico
eletrogalvânicos=electrogalvânicos
eletrogalvanismo=electrogalvanismo
eletrogalvanismos=electrogalvanismos
eletrogéneo=electrogéneo
eletrogéneos=electrogéneos
eletrogénese=electrogénese
eletrogéneses=electrogéneses
eletrogenético=electrogenético
eletrogenéticos=electrogenéticos
eletrógeno=electrógeno
eletrógenos=electrógenos
eletrogerador=electrogerador
eletrogeradores=electrogeradores
eletrografia=electrografia
eletrografias=electrografias
eletrográfico=electrográfico
eletrográficos=electrográficos
eletrógrafo=electrógrafo
eletrógrafos=electrógrafos
eletroíman=electroíman
eletroímans=electroímans
eletrolisa=electrolisa
eletrolisação=electrolisação
eletrolisações=electrolisações
eletrolisada=electrolisada
eletrolisadas=electrolisadas
eletrolisado=electrolisado
eletrolisador=electrolisador
eletrolisadores=electrolisadores
eletrolisados=electrolisados
eletrolisai=electrolisai
eletrolisais=electrolisais
eletrolisam=electrolisam
eletrolisamos=electrolisamos
eletrolisámos=electrolisámos
eletrolisando=electrolisando
eletrolisar=electrolisar
eletrolisara=electrolisara
eletrolisará=electrolisará
eletrolisaram=electrolisaram
eletrolisáramos=electrolisáramos
eletrolisarão=electrolisarão
eletrolisaras=electrolisaras
eletrolisarás=electrolisarás
eletrolisardes=electrolisardes
eletrolisarei=electrolisarei
eletrolisareis=electrolisareis
eletrolisáreis=electrolisáreis
eletrolisarem=electrolisarem
eletrolisaremos=electrolisaremos
eletrolisares=electrolisares
eletrolisaria=electrolisaria
eletrolisariam=electrolisariam
eletrolisaríamos=electrolisaríamos
eletrolisarias=electrolisarias
eletrolisaríeis=electrolisaríeis
eletrolisarmos=electrolisarmos
eletrolisas=electrolisas
eletrolisasse=electrolisasse
eletrolisásseis=electrolisásseis
eletrolisassem=electrolisassem
eletrolisássemos=electrolisássemos
eletrolisasses=electrolisasses
eletrolisaste=electrolisaste
eletrolisastes=electrolisastes
eletrolisava=electrolisava
eletrolisavam=electrolisavam
eletrolisávamos=electrolisávamos
eletrolisavas=electrolisavas
eletrolisáveis=electrolisáveis
eletrolisável=electrolisável
eletrolise=electrolise
eletrólise=electrólise
eletrolisei=electrolisei
eletroliseis=electroliseis
eletrolisem=electrolisem
eletrolisemos=electrolisemos
eletrolises=electrolises
eletrólises=electrólises
eletroliso=electroliso
eletrolisou=electrolisou
eletrolítica=electrolítica
eletrolíticas=electrolíticas
eletrolítico=electrolítico
eletrolíticos=electrolíticos
eletrólito=electrólito
eletrólitos=electrólitos
eletrologia=electrologia
eletrologias=electrologias
eletrológico=electrológico
eletrológicos=electrológicos
eletroluminescência=electroluminescência
eletroluminescências=electroluminescências
eletroluminescente=electroluminescente
eletroluminescentes=electroluminescentes
eletromagnete=electromagnete
eletromagnetes=electromagnetes
eletromagnética=electromagnética
eletromagnéticas=electromagnéticas
eletromagnético=electromagnético
eletromagnéticos=electromagnéticos
eletromagnetismo=electromagnetismo
eletromagnetismos=electromagnetismos
eletromecânica=electromecânica
eletromecânicas=electromecânicas
eletromecânico=electromecânico
eletromecânicos=electromecânicos
eletromeopatia=electromeopatia
eletromeopatias=electromeopatias
eletrometalurgia=electrometalurgia
eletrometalurgias=electrometalurgias
eletrometalúrgico=electrometalúrgico
eletrometalúrgicos=electrometalúrgicos
eletrometria=electrometria
eletrometrias=electrometrias
eletrométrico=electrométrico
eletrométricos=electrométricos
eletrómetro=electrómetro
eletrómetros=electrómetros
eletromiografia=electromiografia
eletromiografias=electromiografias
eletromiograma=electromiograma
eletromiogramas=electromiogramas
eletromotor=electromotor
eletromotores=electromotores
eletromotriz=electromotriz
eletromotrizs=electromotrizs
eletromóveis=electromóveis
eletromóvel=electromóvel
elétron=eléctron
eletronegatividade=electronegatividade
eletronegatividades=electronegatividades
eletronegativo=electronegativo
eletronegativos=electronegativos
eletrónica=electrónica
eletronicamente=electronicamente
eletrónicas=electrónicas
eletrónico=electrónico
eletrónicos=electrónicos
eletrónio=electrónio
eletrónios=electrónios
elétrons=eléctrons
eletropexia=electropexia
eletropexias=electropexias
eletropositividade=electropositividade
eletropositividades=electropositividades
eletropositivo=electropositivo
eletropositivos=electropositivos
eletrótica=electróptica
eletróticas=electrópticas
eletroquímica=electroquímica
eletroquímicas=electroquímicas
eletroquímico=electroquímico
eletroquímicos=electroquímicos
eletrorradiologia=electrorradiologia
eletrorradiologias=electrorradiologias
eletrorradiologista=electrorradiologista
eletrorradiologistas=electrorradiologistas
eletroscopia=electroscopia
eletroscopias=electroscopias
eletroscópico=electroscópico
eletroscópicos=electroscópicos
eletroscópio=electroscópio
eletroscópios=electroscópios
eletrossemáforo=electrossemáforo
eletrossemáforos=electrossemáforos
eletrosserra=electrosserra
eletrosserras=electrosserras
eletrossiderurgia=electrossiderurgia
eletrossiderurgias=electrossiderurgias
eletrossiderúrgico=electrossiderúrgico
eletrossiderúrgicos=electrossiderúrgicos
eletrossoldadura=electrossoldadura
eletrossoldaduras=electrossoldaduras
eletrostática=electrostática
eletrostáticas=electrostáticas
eletrostático=electrostático
eletrostáticos=electrostáticos
eletrostrição=electrostricção
eletrostrições=electrostricções
eletrotanásia=electrotanásia
eletrotanásias=electrotanásias
eletrotecnia=electrotecnia
eletrotecnias=electrotecnias
eletrotécnica=electrotécnica
eletrotécnicas=electrotécnicas
eletrotécnico=electrotécnico
eletrotécnicos=electrotécnicos
eletroterapeuta=electroterapeuta
eletroterapeutas=electroterapeutas
eletroterapêutica=electroterapêutica
eletroterapêuticas=electroterapêuticas
eletroterapêutico=electroterapêutico
eletroterapêuticos=electroterapêuticos
eletroterapia=electroterapia
eletroterapias=electroterapias
eletroterápico=electroterápico
eletroterápicos=electroterápicos
eletrotermia=electrotermia
eletrotermias=electrotermias
eletrotérmico=electrotérmico
eletrotérmicos=electrotérmicos
eletrotipia=electrotipia
eletrotipias=electrotipias
eletrotípico=electrotípico
eletrotípicos=electrotípicos
eletrótipo=electrótipo
eletrótipos=electrótipos
eletrotónico=electrotónico
eletrotónicos=electrotónicos
eletrotropia=electrotropia
eletrotropias=electrotropias
eletrotrópico=electrotrópico
eletrotrópicos=electrotrópicos
eletrotropismo=electrotropismo
eletrotropismos=electrotropismos
eletrovalência=electrovalência
eletrovalências=electrovalências
eletrovalente=electrovalente
eletrovalentes=electrovalentes
eletrovegetómetro=electrovegetómetro
eletrovegetómetros=electrovegetómetros
eletrovitais=electrovitais
eletrovital=electrovital
eletrovitalismo=electrovitalismo
eletrovitalismos=electrovitalismos
eletrozónio=electrozónio
eletrozónios=electrozónios
entreato=entreacto
entreatos=entreactos
epilética=epiléptica
epiléticas=epilépticas
epilético=epiléptico
epiléticos=epilépticos
ereção=erecção
ereções=erecções
ereta=erecta
eretamente=erectamente
eretas=erectas
eréteis=erécteis
eretida=erectida
eretidas=erectidas
erétil=eréctil
eretilidade=erectilidade
eretilidades=erectilidades
ereto=erecto
eretor=erector
eretores=erectores
eretos=erectos
esmético=esméctico
esméticos=esmécticos
espetacular=espectacular
espetaculares=espectaculares
espetacularidade=espectacularidade
espetacularidades=espectacularidades
espetacularmente=espectacularmente
espetáculo=espectáculo
espetáculos=espectáculos
espetaculosamente=espectaculosamente
espetaculosidade=espectaculosidade
espetaculosidades=espectaculosidades
espetaculoso=espectaculoso
espetaculosos=espectaculosos
espetador=espectador
espetadora=espectadora
espetadoras=espectadoras
espetadores=espectadores
esplenenfrático=esplenenfráctico
esplenenfráticos=esplenenfrácticos
esplenopético=esplenopéctico
esplenopéticos=esplenopécticos
estatorreator=estatorreactor
estatorreatores=estatorreactores
estupefação=estupefacção
estupefações=estupefacções
eurocética=eurocéptica
eurocéticas=eurocépticas
euroceticismo=eurocepticismo
euroceticismos=eurocepticismos
eurocético=eurocéptico
eurocéticos=eurocépticos
eurotimismo=europtimismo
eurotimismos=europtimismos
eutático=eutáctico
eutáticos=eutácticos
ex-codiretor=ex-co-director
ex-diretor-geral=ex-director-geral
ex-diretor=ex-director
ex-diretora=ex-directora
ex-diretoras=ex-directoras
ex-diretores=ex-directores
exação=exacção
exações=exacções
exata=exacta
exatamente=exactamente
exatas=exactas
exatibilidade=exactibilidade
exatibilidades=exactibilidades
exatidão=exactidão
exatidões=exactidões
exatificar=exactificar
exatificares=exactificares
exatissimamente=exactissimamente
exatíssimo=exactíssimo
exatíssimos=exactíssimos
exato=exacto
exator=exactor
exatores=exactores
exatoria=exactoria
exatorias=exactorias
exatos=exactos
exceção=excepção
excecionais=excepcionais
excecional=excepcional
excecionalidade=excepcionalidade
excecionalidades=excepcionalidades
excecionalmente=excepcionalmente
excecionar=excepcionar
excecionares=excepcionares
exceções=excepções
exceta=excepta
excetas=exceptas
excetivo=exceptivo
excetivos=exceptivos
exceto=excepto
excetos=exceptos
excetua=exceptua
excetuada=exceptuada
excetuadas=exceptuadas
excetuado=exceptuado
excetuador=exceptuador
excetuadores=exceptuadores
excetuados=exceptuados
excetuai=exceptuai
excetuais=exceptuais
excetuam=exceptuam
excetuamos=exceptuamos
excetuámos=exceptuámos
excetuando=exceptuando
excetuar=exceptuar
excetuara=exceptuara
excetuará=exceptuará
excetuaram=exceptuaram
excetuáramos=exceptuáramos
excetuarão=exceptuarão
excetuaras=exceptuaras
excetuarás=exceptuarás
excetuardes=exceptuardes
excetuarei=exceptuarei
excetuareis=exceptuareis
excetuáreis=exceptuáreis
excetuarem=exceptuarem
excetuaremos=exceptuaremos
excetuares=exceptuares
excetuaria=exceptuaria
excetuariam=exceptuariam
excetuaríamos=exceptuaríamos
excetuarias=exceptuarias
excetuaríeis=exceptuaríeis
excetuarmos=exceptuarmos
excetuas=exceptuas
excetuasse=exceptuasse
excetuásseis=exceptuásseis
excetuassem=exceptuassem
excetuássemos=exceptuássemos
excetuasses=exceptuasses
excetuaste=exceptuaste
excetuastes=exceptuastes
excetuava=exceptuava
excetuavam=exceptuavam
excetuávamos=exceptuávamos
excetuavas=exceptuavas
excetuáveis=exceptuáveis
excetuável=exceptuável
excetue=exceptue
excetuei=exceptuei
excetueis=exceptueis
excetuem=exceptuem
excetuemos=exceptuemos
excetues=exceptues
excetuo=exceptuo
excetuou=exceptuou
expeto=expecto
expetora=expectora
expetoração=expectoração
expetorações=expectorações
expetorada=expectorada
expetoradas=expectoradas
expetorado=expectorado
expetorados=expectorados
expetorai=expectorai
expetorais=expectorais
expetoram=expectoram
expetoramos=expectoramos
expetorámos=expectorámos
expetorando=expectorando
expetorante=expectorante
expetorantes=expectorantes
expetorar=expectorar
expetorara=expectorara
expetorará=expectorará
expetoraram=expectoraram
expetoráramos=expectoráramos
expetorarão=expectorarão
expetoraras=expectoraras
expetorarás=expectorarás
expetorardes=expectorardes
expetorarei=expectorarei
expetorareis=expectorareis
expetoráreis=expectoráreis
expetorarem=expectorarem
expetoraremos=expectoraremos
expetorares=expectorares
expetoraria=expectoraria
expetorariam=expectorariam
expetoraríamos=expectoraríamos
expetorarias=expectorarias
expetoraríeis=expectoraríeis
expetorarmos=expectorarmos
expetoras=expectoras
expetorasse=expectorasse
expetorásseis=expectorásseis
expetorassem=expectorassem
expetorássemos=expectorássemos
expetorasses=expectorasses
expetoraste=expectoraste
expetorastes=expectorastes
expetorava=expectorava
expetoravam=expectoravam
expetorávamos=expectorávamos
expetoravas=expectoravas
expetoráveis=expectoráveis
expetore=expectore
expetorei=expectorei
expetoreis=expectoreis
expetorem=expectorem
expetoremos=expectoremos
expetores=expectores
expetoro=expectoro
expetorou=expectorou
expetou=expectou
exterocetivo=exteroceptivo
exterocetivos=exteroceptivos
exterocetor=exteroceptor
exterocetores=exteroceptores
extraescolar=extra-escolar
extrarregulamentar=extra-regulamentar
extrassensoriais=extra-sensoriais
extrassensorial=extra-sensorial
extrassolar=extra-solar
extrauterino=extra-uterino
extrauterinos=extra-uterinos
extração=extracção
extrações=extracções
extratar=extractar
extratares=extractares
extratiforme=extractiforme
extratiformes=extractiformes
extrativa=extractiva
extrativas=extractivas
extrativo=extractivo
extrativos=extractivos
extrato=extracto
extrator=extractor
extratora=extractora
extratoras=extractoras
extratores=extractores
extratos=extractos
extrojeção=extrojecção
extrojeções=extrojecções
extrospeção=extrospecção
extrospeções=extrospecções
extrospetivo=extrospectivo
extrospetivos=extrospectivos
fação=facção
fações=facções
fator=factor
fatores=factores
fatoriais=factoriais
fatorial=factorial
fatoriza=factoriza
fatorizada=factorizada
fatorizadas=factorizadas
fatorizado=factorizado
fatorizados=factorizados
fatorizai=factorizai
fatorizais=factorizais
fatorizam=factorizam
fatorizamos=factorizamos
fatorizámos=factorizámos
fatorizando=factorizando
fatorizar=factorizar
fatorizara=factorizara
fatorizará=factorizará
fatorizaram=factorizaram
fatorizáramos=factorizáramos
fatorizarão=factorizarão
fatorizaras=factorizaras
fatorizarás=factorizarás
fatorizardes=factorizardes
fatorizarei=factorizarei
fatorizareis=factorizareis
fatorizáreis=factorizáreis
fatorizarem=factorizarem
fatorizaremos=factorizaremos
fatorizares=factorizares
fatorizaria=factorizaria
fatorizariam=factorizariam
fatorizaríamos=factorizaríamos
fatorizarias=factorizarias
fatorizaríeis=factorizaríeis
fatorizarmos=factorizarmos
fatorizas=factorizas
fatorizasse=factorizasse
fatorizásseis=factorizásseis
fatorizassem=factorizassem
fatorizássemos=factorizássemos
fatorizasses=factorizasses
fatorizaste=factorizaste
fatorizastes=factorizastes
fatorizava=factorizava
fatorizavam=factorizavam
fatorizávamos=factorizávamos
fatorizavas=factorizavas
fatorizáveis=factorizáveis
fatorize=factorize
fatorizei=factorizei
fatorizeis=factorizeis
fatorizem=factorizem
fatorizemos=factorizemos
fatorizes=factorizes
fatorizo=factorizo
fatorizou=factorizou
fatura=factura
faturação=facturação
faturações=facturações
faturada=facturada
faturadas=facturadas
faturado=facturado
faturados=facturados
faturai=facturai
faturais=facturais
faturam=facturam
faturamos=facturamos
faturámos=facturámos
faturando=facturando
faturar=facturar
faturara=facturara
faturará=facturará
faturaram=facturaram
faturáramos=facturáramos
faturarão=facturarão
faturaras=facturaras
faturarás=facturarás
faturardes=facturardes
faturarei=facturarei
faturareis=facturareis
faturáreis=facturáreis
faturarem=facturarem
faturaremos=facturaremos
faturares=facturares
faturaria=facturaria
faturariam=facturariam
faturaríamos=facturaríamos
faturarias=facturarias
faturaríeis=facturaríeis
faturarmos=facturarmos
faturas=facturas
faturasse=facturasse
faturásseis=facturásseis
faturassem=facturassem
faturássemos=facturássemos
faturasses=facturasses
faturaste=facturaste
faturastes=facturastes
faturava=facturava
faturavam=facturavam
faturávamos=facturávamos
faturavas=facturavas
faturáveis=facturáveis
faturável=facturável
fature=facture
faturei=facturei
fatureis=factureis
faturem=facturem
faturemos=facturemos
fatures=factures
faturo=facturo
faturou=facturou
ferrieletricidade=ferrielectricidade
ferrieletricidades=ferrielectricidades
ferrielétrico=ferrieléctrico
ferrielétricos=ferrieléctricos
ferroeletricidade=ferroelectricidade
ferroeletricidades=ferroelectricidades
ferroelétrico=ferroeléctrico
ferroelétricos=ferroeléctricos
filocato=filocacto
filocatos=filocactos
filotático=filotáctico
filotáticos=filotácticos
fitotático=fitotáctico
fitotáticos=fitotácticos
flebopético=flebopéctico
flebopéticos=flebopécticos
fleti=flecti
fletia=flectia
fletiam=flectiam
fletíamos=flectíamos
fletias=flectias
fletida=flectida
fletidas=flectidas
fletido=flectido
fletidos=flectidos
fletíeis=flectíeis
fletimos=flectimos
fletindo=flectindo
fletir=flectir
fletira=flectira
fletirá=flectirá
fletiram=flectiram
fletíramos=flectíramos
fletirão=flectirão
fletiras=flectiras
fletirás=flectirás
fletirdes=flectirdes
fletirei=flectirei
fletireis=flectireis
fletíreis=flectíreis
fletirem=flectirem
fletiremos=flectiremos
fletires=flectires
fletiria=flectiria
fletiriam=flectiriam
fletiríamos=flectiríamos
fletirias=flectirias
fletiríeis=flectiríeis
fletirmos=flectirmos
fletisse=flectisse
fletísseis=flectísseis
fletissem=flectissem
fletíssemos=flectíssemos
fletisses=flectisses
fletiste=flectiste
fletistes=flectistes
fletiu=flectiu
fletómetro=flectómetro
fletómetros=flectómetros
fletor=flector
fletores=flectores
flitena=flictena
flitenas=flictenas
foteletrão=fotelectrão
foteletricidade=fotelectricidade
foteletricidades=fotelectricidades
fotelétrico=foteléctrico
fotelétricos=foteléctricos
foteletrões=fotelectrões
fotorrecetor=foto-receptor
fotorrecetores=foto-receptores
fotodielétrico=fotodieléctrico
fotodielétricos=fotodieléctricos
fotoeletrão=fotoelectrão
fotoelétrica=fotoeléctrica
fotoelétricas=fotoeléctricas
fotoeletricidade=fotoelectricidade
fotoeletricidades=fotoelectricidades
fotoelétrico=fotoeléctrico
fotoelétricos=fotoeléctricos
fotoeletrões=fotoelectrões
fotótico=fotóptico
fotóticos=fotópticos
fototático=fototáctico
fototáticos=fototácticos
fração=fracção
fraciona=fracciona
fracionada=fraccionada
fracionadas=fraccionadas
fracionado=fraccionado
fracionados=fraccionados
fracionai=fraccionai
fracionais=fraccionais
fracionam=fraccionam
fracionamento=fraccionamento
fracionamentos=fraccionamentos
fracionamos=fraccionamos
fracionámos=fraccionámos
fracionando=fraccionando
fracionar=fraccionar
fracionara=fraccionara
fracionará=fraccionará
fracionaram=fraccionaram
fracionáramos=fraccionáramos
fracionarão=fraccionarão
fracionaras=fraccionaras
fracionarás=fraccionarás
fracionardes=fraccionardes
fracionarei=fraccionarei
fracionareis=fraccionareis
fracionáreis=fraccionáreis
fracionarem=fraccionarem
fracionaremos=fraccionaremos
fracionares=fraccionares
fracionaria=fraccionaria
fracionariam=fraccionariam
fracionaríamos=fraccionaríamos
fracionarias=fraccionarias
fracionaríeis=fraccionaríeis
fracionário=fraccionário
fracionários=fraccionários
fracionarmos=fraccionarmos
fracionas=fraccionas
fracionasse=fraccionasse
fracionásseis=fraccionásseis
fracionassem=fraccionassem
fracionássemos=fraccionássemos
fracionasses=fraccionasses
fracionaste=fraccionaste
fracionastes=fraccionastes
fracionava=fraccionava
fracionavam=fraccionavam
fracionávamos=fraccionávamos
fracionavas=fraccionavas
fracionáveis=fraccionáveis
fracionável=fraccionável
fracione=fraccione
fracionei=fraccionei
fracioneis=fraccioneis
fracionem=fraccionem
fracionemos=fraccionemos
fraciones=fracciones
fraciono=fracciono
fracionou=fraccionou
fraciúncula=fracciúncula
fraciúnculas=fracciúnculas
frações=fracções
fratura=fractura
fraturada=fracturada
fraturadas=fracturadas
fraturado=fracturado
fraturados=fracturados
fraturai=fracturai
fraturais=fracturais
fraturam=fracturam
fraturamento=fracturamento
fraturamentos=fracturamentos
fraturamos=fracturamos
fraturámos=fracturámos
fraturando=fracturando
fraturante=fracturante
fraturantes=fracturantes
fraturar=fracturar
fraturara=fracturara
fraturará=fracturará
fraturaram=fracturaram
fraturáramos=fracturáramos
fraturarão=fracturarão
fraturaras=fracturaras
fraturarás=fracturarás
fraturardes=fracturardes
fraturarei=fracturarei
fraturareis=fracturareis
fraturáreis=fracturáreis
fraturarem=fracturarem
fraturaremos=fracturaremos
fraturares=fracturares
fraturaria=fracturaria
fraturariam=fracturariam
fraturaríamos=fracturaríamos
fraturarias=fracturarias
fraturaríeis=fracturaríeis
fraturarmos=fracturarmos
fraturas=fracturas
fraturasse=fracturasse
fraturásseis=fracturásseis
fraturassem=fracturassem
fraturássemos=fracturássemos
fraturasses=fracturasses
fraturaste=fracturaste
fraturastes=fracturastes
fraturava=fracturava
fraturavam=fracturavam
fraturávamos=fracturávamos
fraturavas=fracturavas
fraturáveis=fracturáveis
fraturável=fracturável
frature=fracture
fraturei=fracturei
fratureis=fractureis
fraturem=fracturem
fraturemos=fracturemos
fratures=fractures
fraturo=fracturo
fraturou=fracturou
fulano=Fulano
fulanos=Fulanos
galinseto=galinsecto
galinsetos=galinsectos
galvanotático=galvanotáctico
galvanotáticos=galvanotácticos
gastropético=gastropéctico
gastropéticos=gastropécticos
geiser=géiser
genufletir=genuflectir
genufletires=genuflectires
genufletor=genuflector
genufletora=genuflectora
genufletoras=genuflectoras
genufletores=genuflectores
geotático=geotáctico
geotáticos=geotácticos
guarda-noturno=guarda-nocturno
haptotático=haptotáctico
haptotáticos=haptotácticos
heliotatismo=heliotactismo
heliotatismos=heliotactismos
hematossético=hematosséptico
hematosséticos=hematossépticos
hemiatático=hemiatáctico
hemiatáticos=hemiatácticos
hemorroida=hemorróida
hemorroidas=hemorróidas
hemotético=hemotéctico
hemotéticos=hemotécticos
hepatopético=hepatopéctico
hepatopéticos=hepatopécticos
heteroinfeção=heteroinfecção
heteroinfeções=heteroinfecções
heterorrético=heterorréctico
heterorréticos=heterorrécticos
heterossético=heterosséptico
heterosséticos=heterossépticos
heterotático=heterotáctico
heterotáticos=heterotácticos
hidrelétrico=hidreléctrico
hidrelétricos=hidreléctricos
hidroelétrica=hidroeléctrica
hidroelétricas=hidroeléctricas
hidroeletricidade=hidroelectricidade
hidroeletricidades=hidroelectricidades
hidroelétrico=hidroeléctrico
hidroelétricos=hidroeléctricos
hidroextrator=hidroextractor
hidroextratores=hidroextractores
hidrofrático=hidrofráctico
hidrofráticos=hidrofrácticos
hiperatividade=hiperactividade
hiperatividades=hiperactividades
hiperativo=hiperactivo
hiperativos=hiperactivos
hipercatalético=hipercataléctico
hipercataléticos=hipercatalécticos
hipercataleto=hipercatalecto
hipercataletos=hipercatalectos
hipercorreção=hipercorrecção
hipercorreções=hipercorrecções
hipercorreto=hipercorrecto
hipercorretos=hipercorrectos
hiperdialético=hiperdialéctico
hiperdialéticos=hiperdialécticos
hipereutético=hipereutéctico
hipereutéticos=hipereutécticos
hiperproteção=hiperprotecção
hiperproteções=hiperprotecções
hipeutético=hipeutéctico
hipeutéticos=hipeutécticos
hipotático=hipotáctico
hipotáticos=hipotácticos
histeropético=histeropéctico
histeropéticos=histeropécticos
holantártico=holantárctico
holantárticos=holantárcticos
homeocatalético=homeocataléctico
homeocataléticos=homeocatalécticos
homeocataleto=homeocatalecto
homeocataletos=homeocatalectos
idieletricidade=idielectricidade
idieletricidades=idielectricidades
idielétrico=idieléctrico
idielétricos=idieléctricos
idioelétrico=idioeléctrico
idioelétricos=idioeléctricos
idioleto=idiolecto
idioletos=idiolectos
impercetibilidade=imperceptibilidade
impercetibilidades=imperceptibilidades
impercetíveis=imperceptíveis
impercetível=imperceptível
impercetivelmente=imperceptivelmente
imputrefação=imputrefacção
imputrefações=imputrefacções
imunoeletroforese=imunoelectroforese
imunoeletroforeses=imunoelectroforeses
imunorreação=imunorreacção
imunorreações=imunorreacções
imunorreativo=imunorreactivo
imunorreativos=imunorreactivos
inação=inacção
inações=inacções
inativa=inactiva
inativação=inactivação
inativações=inactivações
inativamente=inactivamente
inativar=inactivar
inativares=inactivares
inativas=inactivas
inatividade=inactividade
inatividades=inactividades
inativo=inactivo
inativos=inactivos
inatuais=inactuais
inatual=inactual
inadotáveis=inadoptáveis
inadotável=inadoptável
inafetivo=inafectivo
inafetivos=inafectivos
incorreção=incorrecção
incorreções=incorrecções
incorreta=incorrecta
incorretamente=incorrectamente
incorretas=incorrectas
incorretíssima=incorrectíssima
incorretíssimas=incorrectíssimas
incorretíssimo=incorrectíssimo
incorretíssimos=incorrectíssimos
incorreto=incorrecto
incorretos=incorrectos
indefetibilidade=indefectibilidade
indefetibilidades=indefectibilidades
indefetíveis=indefectíveis
indefetível=indefectível
indefetivelmente=indefectivelmente
indetetáveis=indetectáveis
indetetável=indetectável
indireção=indirecção
indireções=indirecções
indireta=indirecta
indiretamente=indirectamente
indiretas=indirectas
indireto=indirecto
indiretos=indirectos
inefetivo=inefectivo
inefetivos=inefectivos
inexação=inexacção
inexações=inexacções
inexata=inexacta
inexatamente=inexactamente
inexatas=inexactas
inexatidão=inexactidão
inexatidões=inexactidões
inexato=inexacto
inexatos=inexactos
infantojuvenil=infanto-juvenil
infantojuvenis=infanto-juvenis
infeção=infecção
infeciologia=infecciologia
infeciologias=infecciologias
infeciologista=infecciologista
infeciologistas=infecciologistas
infeções=infecções
infeta=infecta
infetada=infectada
infetadas=infectadas
infetado=infectado
infetados=infectados
infetai=infectai
infetais=infectais
infetam=infectam
infetamos=infectamos
infetámos=infectámos
infetando=infectando
infetante=infectante
infetantes=infectantes
infetar=infectar
infetara=infectara
infetará=infectará
infetaram=infectaram
infetáramos=infectáramos
infetarão=infectarão
infetaras=infectaras
infetarás=infectarás
infetardes=infectardes
infetarei=infectarei
infetareis=infectareis
infetáreis=infectáreis
infetarem=infectarem
infetaremos=infectaremos
infetares=infectares
infetaria=infectaria
infetariam=infectariam
infetaríamos=infectaríamos
infetarias=infectarias
infetaríeis=infectaríeis
infetarmos=infectarmos
infetas=infectas
infetasse=infectasse
infetásseis=infectásseis
infetassem=infectassem
infetássemos=infectássemos
infetasses=infectasses
infetaste=infectaste
infetastes=infectastes
infetava=infectava
infetavam=infectavam
infetávamos=infectávamos
infetavas=infectavas
infetáveis=infectáveis
infetável=infectável
infete=infecte
infetei=infectei
infeteis=infecteis
infetem=infectem
infetemos=infectemos
infetes=infectes
infeto=infecto
infetologia=infectologia
infetologias=infectologias
infetológico=infectológico
infetológicos=infectológicos
infetou=infectou
infetuosidade=infectuosidade
infetuosidades=infectuosidades
infetuoso=infectuoso
infleti=inflecti
infletia=inflectia
infletiam=inflectiam
infletíamos=inflectíamos
infletias=inflectias
infletida=inflectida
infletidas=inflectidas
infletido=inflectido
infletidos=inflectidos
infletíeis=inflectíeis
infletimos=inflectimos
infletindo=inflectindo
infletir=inflectir
infletira=inflectira
infletirá=inflectirá
infletiram=inflectiram
infletíramos=inflectíramos
infletirão=inflectirão
infletiras=inflectiras
infletirás=inflectirás
infletirdes=inflectirdes
infletirei=inflectirei
infletireis=inflectireis
infletíreis=inflectíreis
infletirem=inflectirem
infletiremos=inflectiremos
infletires=inflectires
infletiria=inflectiria
infletiriam=inflectiriam
infletiríamos=inflectiríamos
infletirias=inflectirias
infletiríeis=inflectiríeis
infletirmos=inflectirmos
infletisse=inflectisse
infletísseis=inflectísseis
infletissem=inflectissem
infletíssemos=inflectíssemos
infletisses=inflectisses
infletiste=inflectiste
infletistes=inflectistes
infletiu=inflectiu
inflição=inflicção
inflições=inflicções
infraestrutura=infra-estrutura
infraestruturas=infra-estruturas
infrarrenal=infra-renal
infrassom=infra-som
infração=infracção
infrações=infracções
infrator=infractor
infratora=infractora
infratoras=infractoras
infratores=infractores
injeção=injecção
injeções=injecções
injeta=injecta
injetada=injectada
injetadas=injectadas
injetado=injectado
injetador=injectador
injetadores=injectadores
injetados=injectados
injetai=injectai
injetais=injectais
injetam=injectam
injetamos=injectamos
injetámos=injectámos
injetando=injectando
injetar=injectar
injetara=injectara
injetará=injectará
injetaram=injectaram
injetáramos=injectáramos
injetarão=injectarão
injetaras=injectaras
injetarás=injectarás
injetardes=injectardes
injetarei=injectarei
injetareis=injectareis
injetáreis=injectáreis
injetarem=injectarem
injetaremos=injectaremos
injetares=injectares
injetaria=injectaria
injetariam=injectariam
injetaríamos=injectaríamos
injetarias=injectarias
injetaríeis=injectaríeis
injetarmos=injectarmos
injetas=injectas
injetasse=injectasse
injetásseis=injectásseis
injetassem=injectassem
injetássemos=injectássemos
injetasses=injectasses
injetaste=injectaste
injetastes=injectastes
injetava=injectava
injetavam=injectavam
injetávamos=injectávamos
injetavas=injectavas
injetáveis=injectáveis
injetável=injectável
injete=injecte
injetei=injectei
injeteis=injecteis
injetem=injectem
injetemos=injectemos
injetes=injectes
injetiva=injectiva
injetivamente=injectivamente
injetivas=injectivas
injetividade=injectividade
injetividades=injectividades
injetivo=injectivo
injetivos=injectivos
injeto=injecto
injetor=injector
injetores=injectores
injetos=injectos
injetou=injectou
inobjetáveis=inobjectáveis
inobjetável=inobjectável
inobjetividade=inobjectividade
inobjetividades=inobjectividades
inopético=inopéctico
inopéticos=inopécticos
inseticida=insecticida
inseticidas=insecticidas
inseticídio=insecticídio
inseticídios=insecticídios
inseto=insecto
insetos=insectos
inspeção=inspecção
inspeciona=inspecciona
inspecionada=inspeccionada
inspecionadas=inspeccionadas
inspecionado=inspeccionado
inspecionador=inspeccionador
inspecionadora=inspeccionadora
inspecionadoras=inspeccionadoras
inspecionadores=inspeccionadores
inspecionados=inspeccionados
inspecionai=inspeccionai
inspecionais=inspeccionais
inspecionam=inspeccionam
inspecionamento=inspeccionamento
inspecionamentos=inspeccionamentos
inspecionamos=inspeccionamos
inspecionámos=inspeccionámos
inspecionando=inspeccionando
inspecionar=inspeccionar
inspecionara=inspeccionara
inspecionará=inspeccionará
inspecionaram=inspeccionaram
inspecionáramos=inspeccionáramos
inspecionarão=inspeccionarão
inspecionaras=inspeccionaras
inspecionarás=inspeccionarás
inspecionardes=inspeccionardes
inspecionarei=inspeccionarei
inspecionareis=inspeccionareis
inspecionáreis=inspeccionáreis
inspecionarem=inspeccionarem
inspecionaremos=inspeccionaremos
inspecionares=inspeccionares
inspecionaria=inspeccionaria
inspecionariam=inspeccionariam
inspecionaríamos=inspeccionaríamos
inspecionarias=inspeccionarias
inspecionaríeis=inspeccionaríeis
inspecionarmos=inspeccionarmos
inspecionas=inspeccionas
inspecionasse=inspeccionasse
inspecionásseis=inspeccionásseis
inspecionassem=inspeccionassem
inspecionássemos=inspeccionássemos
inspecionasses=inspeccionasses
inspecionaste=inspeccionaste
inspecionastes=inspeccionastes
inspecionava=inspeccionava
inspecionavam=inspeccionavam
inspecionávamos=inspeccionávamos
inspecionavas=inspeccionavas
inspecionáveis=inspeccionáveis
inspecionável=inspeccionável
inspecione=inspeccione
inspecionei=inspeccionei
inspecioneis=inspeccioneis
inspecionem=inspeccionem
inspecionemos=inspeccionemos
inspeciones=inspecciones
inspeciono=inspecciono
inspecionou=inspeccionou
inspeções=inspecções
inspeta=inspecta
inspetada=inspectada
inspetadas=inspectadas
inspetado=inspectado
inspetados=inspectados
inspetai=inspectai
inspetais=inspectais
inspetam=inspectam
inspetamos=inspectamos
inspetámos=inspectámos
inspetando=inspectando
inspetar=inspectar
inspetara=inspectara
inspetará=inspectará
inspetaram=inspectaram
inspetáramos=inspectáramos
inspetarão=inspectarão
inspetaras=inspectaras
inspetarás=inspectarás
inspetardes=inspectardes
inspetarei=inspectarei
inspetareis=inspectareis
inspetáreis=inspectáreis
inspetarem=inspectarem
inspetaremos=inspectaremos
inspetares=inspectares
inspetaria=inspectaria
inspetariam=inspectariam
inspetaríamos=inspectaríamos
inspetarias=inspectarias
inspetaríeis=inspectaríeis
inspetarmos=inspectarmos
inspetas=inspectas
inspetasse=inspectasse
inspetásseis=inspectásseis
inspetassem=inspectassem
inspetássemos=inspectássemos
inspetasses=inspectasses
inspetaste=inspectaste
inspetastes=inspectastes
inspetava=inspectava
inspetavam=inspectavam
inspetávamos=inspectávamos
inspetavas=inspectavas
inspetáveis=inspectáveis
inspete=inspecte
inspetei=inspectei
inspeteis=inspecteis
inspetem=inspectem
inspetemos=inspectemos
inspetes=inspectes
inspetivo=inspectivo
inspetivos=inspectivos
inspeto=inspecto
inspetor-geral=inspector-geral
inspetor=inspector
inspetora=inspectora
inspetorado=inspectorado
inspetorados=inspectorados
inspetoras=inspectoras
inspetores=inspectores
inspetoria=inspectoria
inspetorias=inspectorias
inspetório=inspectório
inspetórios=inspectórios
inspetou=inspectou
insurreciona=insurrecciona
insurrecionada=insurreccionada
insurrecionadas=insurreccionadas
insurrecionado=insurreccionado
insurrecionados=insurreccionados
insurrecionai=insurreccionai
insurrecionais=insurreccionais
insurrecional=insurreccional
insurrecionalmente=insurreccionalmente
insurrecionam=insurreccionam
insurrecionamos=insurreccionamos
insurrecionámos=insurreccionámos
insurrecionando=insurreccionando
insurrecionar=insurreccionar
insurrecionara=insurreccionara
insurrecionará=insurreccionará
insurrecionaram=insurreccionaram
insurrecionáramos=insurreccionáramos
insurrecionarão=insurreccionarão
insurrecionaras=insurreccionaras
insurrecionarás=insurreccionarás
insurrecionardes=insurreccionardes
insurrecionarei=insurreccionarei
insurrecionareis=insurreccionareis
insurrecionáreis=insurreccionáreis
insurrecionarem=insurreccionarem
insurrecionaremos=insurreccionaremos
insurrecionares=insurreccionares
insurrecionaria=insurreccionaria
insurrecionariam=insurreccionariam
insurrecionaríamos=insurreccionaríamos
insurrecionarias=insurreccionarias
insurrecionaríeis=insurreccionaríeis
insurrecionário=insurreccionário
insurrecionários=insurreccionários
insurrecionarmos=insurreccionarmos
insurrecionas=insurreccionas
insurrecionasse=insurreccionasse
insurrecionásseis=insurreccionásseis
insurrecionassem=insurreccionassem
insurrecionássemos=insurreccionássemos
insurrecionasses=insurreccionasses
insurrecionaste=insurreccionaste
insurrecionastes=insurreccionastes
insurrecionava=insurreccionava
insurrecionavam=insurreccionavam
insurrecionávamos=insurreccionávamos
insurrecionavas=insurreccionavas
insurrecionáveis=insurreccionáveis
insurrecionável=insurreccionável
insurrecione=insurreccione
insurrecionei=insurreccionei
insurrecioneis=insurreccioneis
insurrecionem=insurreccionem
insurrecionemos=insurreccionemos
insurreciones=insurrecciones
insurrecionismo=insurreccionismo
insurrecionismos=insurreccionismos
insurreciono=insurrecciono
insurrecionou=insurreccionou
insurreta=insurrecta
insurretas=insurrectas
insurreto=insurrecto
insurretos=insurrectos
insuscetíveis=insusceptíveis
insuscetível=insusceptível
insuscetivelmente=insusceptivelmente
inteleção=intelecção
interação=interacção
interacionismo=interaccionismo
interacionismos=interaccionismos
interações=interacções
interativa=interactiva
interativamente=interactivamente
interativas=interactivas
interatividade=interactividade
interatividades=interactividades
interativo=interactivo
interativos=interactivos
interatua=interactua
interatuada=interactuada
interatuadas=interactuadas
interatuado=interactuado
interatuados=interactuados
interatuai=interactuai
interatuais=interactuais
interatuam=interactuam
interatuamos=interactuamos
interatuámos=interactuámos
interatuando=interactuando
interatuante=interactuante
interatuantes=interactuantes
interatuar=interactuar
interatuara=interactuara
interatuará=interactuará
interatuaram=interactuaram
interatuáramos=interactuáramos
interatuarão=interactuarão
interatuaras=interactuaras
interatuarás=interactuarás
interatuardes=interactuardes
interatuarei=interactuarei
interatuareis=interactuareis
interatuáreis=interactuáreis
interatuarem=interactuarem
interatuaremos=interactuaremos
interatuares=interactuares
interatuaria=interactuaria
interatuariam=interactuariam
interatuaríamos=interactuaríamos
interatuarias=interactuarias
interatuaríeis=interactuaríeis
interatuarmos=interactuarmos
interatuas=interactuas
interatuasse=interactuasse
interatuásseis=interactuásseis
interatuassem=interactuassem
interatuássemos=interactuássemos
interatuasses=interactuasses
interatuaste=interactuaste
interatuastes=interactuastes
interatuava=interactuava
interatuavam=interactuavam
interatuávamos=interactuávamos
interatuavas=interactuavas
interatuáveis=interactuáveis
interatue=interactue
interatuei=interactuei
interatueis=interactueis
interatuem=interactuem
interatuemos=interactuemos
interatues=interactues
interatuo=interactuo
interatuou=interactuou
interceção=intercepção
interceções=intercepções
interceta=intercepta
intercetação=interceptação
intercetações=interceptações
intercetada=interceptada
intercetadas=interceptadas
intercetado=interceptado
intercetador=interceptador
intercetadora=interceptadora
intercetadoras=interceptadoras
intercetadores=interceptadores
intercetados=interceptados
intercetai=interceptai
intercetais=interceptais
intercetam=interceptam
intercetamos=interceptamos
intercetámos=interceptámos
intercetando=interceptando
intercetante=interceptante
intercetantes=interceptantes
intercetar=interceptar
intercetara=interceptara
intercetará=interceptará
intercetaram=interceptaram
intercetáramos=interceptáramos
intercetarão=interceptarão
intercetaras=interceptaras
intercetarás=interceptarás
intercetardes=interceptardes
intercetarei=interceptarei
intercetareis=interceptareis
intercetáreis=interceptáreis
intercetarem=interceptarem
intercetaremos=interceptaremos
intercetares=interceptares
intercetaria=interceptaria
intercetariam=interceptariam
intercetaríamos=interceptaríamos
intercetarias=interceptarias
intercetaríeis=interceptaríeis
intercetarmos=interceptarmos
intercetas=interceptas
intercetasse=interceptasse
intercetásseis=interceptásseis
intercetassem=interceptassem
intercetássemos=interceptássemos
intercetasses=interceptasses
intercetaste=interceptaste
intercetastes=interceptastes
intercetava=interceptava
intercetavam=interceptavam
intercetávamos=interceptávamos
intercetavas=interceptavas
intercetáveis=interceptáveis
intercetável=interceptável
intercete=intercepte
intercetei=interceptei
interceteis=intercepteis
intercetem=interceptem
intercetemos=interceptemos
intercetes=interceptes
intercetivo=interceptivo
intercetivos=interceptivos
interceto=intercepto
intercetor=interceptor
intercetora=interceptora
intercetoras=interceptoras
intercetores=interceptores
intercetório=interceptório
intercetórios=interceptórios
intercetou=interceptou
interjecionais=interjeccionais
interjecional=interjeccional
interjecionar=interjeccionar
interjecionares=interjeccionares
interjetivamente=interjectivamente
interjetivo=interjectivo
interjetivos=interjectivos
intersubjetiva=intersubjectiva
intersubjetivas=intersubjectivas
intersubjetividade=intersubjectividade
intersubjetividades=intersubjectividades
intersubjetivo=intersubjectivo
intersubjetivos=intersubjectivos
intrauterina=intra-uterina
intrauterinas=intra-uterinas
intrauterino=intra-uterino
introito=intróito
introitos=intróitos
introjeção=introjecção
introjeções=introjecções
introspeção=introspecção
introspecionista=introspeccionista
introspecionistas=introspeccionistas
introspeções=introspecções
introspetiva=introspectiva
introspetivamente=introspectivamente
introspetivas=introspectivas
introspetivo=introspectivo
introspetivos=introspectivos
intusceção=intuscepção
intusceções=intuscepções
intuspeção=intuspecção
intuspeções=intuspecções
intuspetivamente=intuspectivamente
intuspetivo=intuspectivo
intuspetivos=intuspectivos
intussusceção=intussuscepção
intussusceções=intussuscepções
inumetação=inumectação
inumetações=inumectações
invetiva=invectiva
invetivada=invectivada
invetivadas=invectivadas
invetivado=invectivado
invetivador=invectivador
invetivadora=invectivadora
invetivadoras=invectivadoras
invetivadores=invectivadores
invetivados=invectivados
invetivai=invectivai
invetivais=invectivais
invetivam=invectivam
invetivamos=invectivamos
invetivámos=invectivámos
invetivando=invectivando
invetivante=invectivante
invetivantes=invectivantes
invetivar=invectivar
invetivara=invectivara
invetivará=invectivará
invetivaram=invectivaram
invetiváramos=invectiváramos
invetivarão=invectivarão
invetivaras=invectivaras
invetivarás=invectivarás
invetivardes=invectivardes
invetivarei=invectivarei
invetivareis=invectivareis
invetiváreis=invectiváreis
invetivarem=invectivarem
invetivaremos=invectivaremos
invetivares=invectivares
invetivaria=invectivaria
invetivariam=invectivariam
invetivaríamos=invectivaríamos
invetivarias=invectivarias
invetivaríeis=invectivaríeis
invetivarmos=invectivarmos
invetivas=invectivas
invetivasse=invectivasse
invetivásseis=invectivásseis
invetivassem=invectivassem
invetivássemos=invectivássemos
invetivasses=invectivasses
invetivaste=invectivaste
invetivastes=invectivastes
invetivava=invectivava
invetivavam=invectivavam
invetivávamos=invectivávamos
invetivavas=invectivavas
invetiváveis=invectiváveis
invetive=invective
invetivei=invectivei
invetiveis=invectiveis
invetivem=invectivem
invetivemos=invectivemos
invetives=invectives
invetivista=invectivista
invetivistas=invectivistas
invetivo=invectivo
invetivos=invectivos
invetivou=invectivou
iridorrético=iridorréctico
iridorréticos=iridorrécticos
irrefletida=irreflectida
irrefletidamente=irreflectidamente
irrefletidas=irreflectidas
irrefletido=irreflectido
irrefletidos=irreflectidos
irretratáveis=irretractáveis
irretratável=irretractável
irretratavelmente=irretractavelmente
irretroatividade=irretroactividade
irretroatividades=irretroactividades
irretroativo=irretroactivo
irretroativos=irretroactivos
iselétrico=iseléctrico
iselétricos=iseléctricos
isoelétrico=isoeléctrico
isoelétricos=isoeléctricos
isoeletrónico=isoelectrónico
isoeletrónicos=isoelectrónicos
jato=jacto
jatoplanador=jactoplanador
jatoplanadores=jactoplanadores
jatos=jactos
joina=jóina
joinas=jóinas
leem=lêem
leciona=lecciona
lecionação=leccionação
lecionações=leccionações
lecionada=leccionada
lecionadas=leccionadas
lecionado=leccionado
lecionador=leccionador
lecionadora=leccionadora
lecionadoras=leccionadoras
lecionadores=leccionadores
lecionados=leccionados
lecionai=leccionai
lecionais=leccionais
lecionam=leccionam
lecionamos=leccionamos
lecionámos=leccionámos
lecionando=leccionando
lecionandos=leccionandos
lecionar=leccionar
lecionara=leccionara
lecionará=leccionará
lecionaram=leccionaram
lecionáramos=leccionáramos
lecionarão=leccionarão
lecionaras=leccionaras
lecionarás=leccionarás
lecionardes=leccionardes
lecionarei=leccionarei
lecionareis=leccionareis
lecionáreis=leccionáreis
lecionarem=leccionarem
lecionaremos=leccionaremos
lecionares=leccionares
lecionaria=leccionaria
lecionariam=leccionariam
lecionaríamos=leccionaríamos
lecionarias=leccionarias
lecionaríeis=leccionaríeis
lecionário=leccionário
lecionários=leccionários
lecionarmos=leccionarmos
lecionas=leccionas
lecionasse=leccionasse
lecionásseis=leccionásseis
lecionassem=leccionassem
lecionássemos=leccionássemos
lecionasses=leccionasses
lecionaste=leccionaste
lecionastes=leccionastes
lecionava=leccionava
lecionavam=leccionavam
lecionávamos=leccionávamos
lecionavas=leccionavas
lecionáveis=leccionáveis
lecionável=leccionável
lecione=leccione
lecionei=leccionei
lecioneis=leccioneis
lecionem=leccionem
lecionemos=leccionemos
leciones=lecciones
lecionista=leccionista
lecionistas=leccionistas
leciono=lecciono
lecionou=leccionou
letiva=lectiva
letivas=lectivas
letivo=lectivo
letivos=lectivos
liquefação=liquefacção
liquefações=liquefacções
liquefator=liquefactor
liquefatores=liquefactores
madefação=madefacção
madefações=madefacções
magnetelétrico=magneteléctrico
magnetelétricos=magneteléctricos
malático=maláctico
maláticos=malácticos
mandachuva=manda-chuva
mandachuvas=manda-chuvas
manufator=manufactor
manufatora=manufactora
manufatoras=manufactoras
manufatores=manufactores
manufatura=manufactura
manufaturação=manufacturação
manufaturações=manufacturações
manufaturada=manufacturada
manufaturadas=manufacturadas
manufaturado=manufacturado
manufaturador=manufacturador
manufaturadores=manufacturadores
manufaturados=manufacturados
manufaturai=manufacturai
manufaturais=manufacturais
manufaturam=manufacturam
manufaturamos=manufacturamos
manufaturámos=manufacturámos
manufaturando=manufacturando
manufaturar=manufacturar
manufaturara=manufacturara
manufaturará=manufacturará
manufaturaram=manufacturaram
manufaturáramos=manufacturáramos
manufaturarão=manufacturarão
manufaturaras=manufacturaras
manufaturarás=manufacturarás
manufaturardes=manufacturardes
manufaturarei=manufacturarei
manufaturareis=manufacturareis
manufaturáreis=manufacturáreis
manufaturarem=manufacturarem
manufaturaremos=manufacturaremos
manufaturares=manufacturares
manufaturaria=manufacturaria
manufaturariam=manufacturariam
manufaturaríamos=manufacturaríamos
manufaturarias=manufacturarias
manufaturaríeis=manufacturaríeis
manufaturarmos=manufacturarmos
manufaturas=manufacturas
manufaturasse=manufacturasse
manufaturásseis=manufacturásseis
manufaturassem=manufacturassem
manufaturássemos=manufacturássemos
manufaturasses=manufacturasses
manufaturaste=manufacturaste
manufaturastes=manufacturastes
manufaturava=manufacturava
manufaturavam=manufacturavam
manufaturávamos=manufacturávamos
manufaturavas=manufacturavas
manufaturáveis=manufacturáveis
manufaturável=manufacturável
manufature=manufacture
manufaturei=manufacturei
manufatureiro=manufactureiro
manufatureiros=manufactureiros
manufatureis=manufactureis
manufaturem=manufacturem
manufaturemos=manufacturemos
manufatures=manufactures
manufaturo=manufacturo
manufaturou=manufacturou
maquinofatura=maquinofactura
maquinofaturas=maquinofacturas
megaprojeto=megaprojecto
megaprojetos=megaprojectos
melocato=melocacto
melocatos=melocactos
meningocócico=meningocóccico
meningocócicos=meningocóccicos
merozoito=merozóito
merozoitos=merozóitos
mesorreto=mesorrecto
mesorretos=mesorrectos
metalético=metaléptico
metaléticos=metalépticos
metamorfótico=metamorfóptico
metamorfóticos=metamorfópticos
metapético=metapéctico
metapéticos=metapécticos
metapetina=metapectina
metapetinas=metapectinas
metrorrético=metrorréctico
metrorréticos=metrorrécticos
microbjetiva=microbjectiva
microbjetivas=microbjectivas
microeletrónica=microelectrónica
microeletrónicas=microelectrónicas
minissaia=mini-saia
minissaias=mini-saias
mioprático=miopráctico
miopráticos=mioprácticos
morfossintática=morfossintáctica
morfossintáticas=morfossintácticas
morfossintático=morfossintáctico
morfossintáticos=morfossintácticos
multidirecionais=multidireccionais
multidirecional=multidireccional
multifatoriais=multifactoriais
multifatorial=multifactorial
multinfeção=multinfecção
multinfeções=multinfecções
nefropético=nefropéctico
nefropéticos=nefropécticos
neorrealismo=neo-realismo
neorrealismos=neo-realismos
neorrealista=neo-realista
neorrealistas=neo-realistas
neorromantismo=neo-romantismo
noturna=nocturna
noturnais=nocturnais
noturnal=nocturnal
noturnamente=nocturnamente
noturnas=nocturnas
noturno=nocturno
noturnos=nocturnos
obduto=obducto
obdutos=obductos
objeção=objecção
objeções=objecções
objeta=objecta
objetada=objectada
objetadas=objectadas
objetado=objectado
objetados=objectados
objetai=objectai
objetais=objectais
objetal=objectal
objetam=objectam
objetamos=objectamos
objetámos=objectámos
objetando=objectando
objetante=objectante
objetantes=objectantes
objetar=objectar
objetara=objectara
objetará=objectará
objetaram=objectaram
objetáramos=objectáramos
objetarão=objectarão
objetaras=objectaras
objetarás=objectarás
objetardes=objectardes
objetarei=objectarei
objetareis=objectareis
objetáreis=objectáreis
objetarem=objectarem
objetaremos=objectaremos
objetares=objectares
objetaria=objectaria
objetariam=objectariam
objetaríamos=objectaríamos
objetarias=objectarias
objetaríeis=objectaríeis
objetarmos=objectarmos
objetas=objectas
objetasse=objectasse
objetásseis=objectásseis
objetassem=objectassem
objetássemos=objectássemos
objetasses=objectasses
objetaste=objectaste
objetastes=objectastes
objetava=objectava
objetavam=objectavam
objetávamos=objectávamos
objetavas=objectavas
objetáveis=objectáveis
objetável=objectável
objete=objecte
objetei=objectei
objeteis=objecteis
objetem=objectem
objetemos=objectemos
objetes=objectes
objetiva=objectiva
objetivação=objectivação
objetivações=objectivações
objetivada=objectivada
objetivadas=objectivadas
objetivado=objectivado
objetivador=objectivador
objetivadores=objectivadores
objetivados=objectivados
objetivai=objectivai
objetivais=objectivais
objetivam=objectivam
objetivamente=objectivamente
objetivamos=objectivamos
objetivámos=objectivámos
objetivando=objectivando
objetivante=objectivante
objetivantes=objectivantes
objetivar=objectivar
objetivara=objectivara
objetivará=objectivará
objetivaram=objectivaram
objetiváramos=objectiváramos
objetivarão=objectivarão
objetivaras=objectivaras
objetivarás=objectivarás
objetivardes=objectivardes
objetivarei=objectivarei
objetivareis=objectivareis
objetiváreis=objectiváreis
objetivarem=objectivarem
objetivaremos=objectivaremos
objetivares=objectivares
objetivaria=objectivaria
objetivariam=objectivariam
objetivaríamos=objectivaríamos
objetivarias=objectivarias
objetivaríeis=objectivaríeis
objetivarmos=objectivarmos
objetivas=objectivas
objetivasse=objectivasse
objetivásseis=objectivásseis
objetivassem=objectivassem
objetivássemos=objectivássemos
objetivasses=objectivasses
objetivaste=objectivaste
objetivastes=objectivastes
objetivava=objectivava
objetivavam=objectivavam
objetivávamos=objectivávamos
objetivavas=objectivavas
objetiváveis=objectiváveis
objetivável=objectivável
objetive=objective
objetivei=objectivei
objetiveis=objectiveis
objetivem=objectivem
objetivemos=objectivemos
objetives=objectives
objetividade=objectividade
objetividades=objectividades
objetivismo=objectivismo
objetivismos=objectivismos
objetivista=objectivista
objetivistas=objectivistas
objetivo=objectivo
objetivos=objectivos
objetivou=objectivou
objeto=objecto
objetologia=objectologia
objetologias=objectologias
objetológico=objectológico
objetológicos=objectológicos
objetologista=objectologista
objetologistas=objectologistas
objetólogo=objectólogo
objetólogos=objectólogos
objetor=objector
objetora=objectora
objetoras=objectoras
objetores=objectores
objetos=objectos
objetou=objectou
obstupefação=obstupefacção
obstupefações=obstupefacções
otávia=octávia
Otaviano=Octaviano
otávias=octávias
olfação=olfacção
olfações=olfacções
olfata=olfacta
olfatada=olfactada
olfatadas=olfactadas
olfatado=olfactado
olfatados=olfactados
olfatai=olfactai
olfatais=olfactais
olfatam=olfactam
olfatamos=olfactamos
olfatámos=olfactámos
olfatando=olfactando
olfatar=olfactar
olfatara=olfactara
olfatará=olfactará
olfataram=olfactaram
olfatáramos=olfactáramos
olfatarão=olfactarão
olfataras=olfactaras
olfatarás=olfactarás
olfatardes=olfactardes
olfatarei=olfactarei
olfatareis=olfactareis
olfatáreis=olfactáreis
olfatarem=olfactarem
olfataremos=olfactaremos
olfatares=olfactares
olfataria=olfactaria
olfatariam=olfactariam
olfataríamos=olfactaríamos
olfatarias=olfactarias
olfataríeis=olfactaríeis
olfatarmos=olfactarmos
olfatas=olfactas
olfatasse=olfactasse
olfatásseis=olfactásseis
olfatassem=olfactassem
olfatássemos=olfactássemos
olfatasses=olfactasses
olfataste=olfactaste
olfatastes=olfactastes
olfatava=olfactava
olfatavam=olfactavam
olfatávamos=olfactávamos
olfatavas=olfactavas
olfatáveis=olfactáveis
olfate=olfacte
olfatei=olfactei
olfateis=olfacteis
olfatem=olfactem
olfatemos=olfactemos
olfates=olfactes
olfática=olfáctica
olfáticas=olfácticas
olfático=olfáctico
olfáticos=olfácticos
olfativa=olfactiva
olfativamente=olfactivamente
olfativas=olfactivas
olfativo=olfactivo
olfativos=olfactivos
olfato=olfacto
olfatometria=olfactometria
olfatometrias=olfactometrias
olfatométrico=olfactométrico
olfatométricos=olfactométricos
olfatómetro=olfactómetro
olfatómetros=olfactómetros
olfatório=olfactório
olfatórios=olfactórios
olfatos=olfactos
olfatou=olfactou
omnidirecionais=omnidireccionais
omnidirecional=omnidireccional
ótica=óptica
oticamente=opticamente
óticas=ópticas
oticidade=opticidade
oticidades=opticidades
oticista=opticista
oticistas=opticistas
ótico=óptico
óticos=ópticos
ótima=óptima
otimamente=optimamente
ótimas=óptimas
otimismo=optimismo
otimismos=optimismos
otimista=optimista
otimistas=optimistas
otimístico=optimístico
otimísticos=optimísticos
otimiza=optimiza
otimização=optimização
otimizações=optimizações
otimizada=optimizada
otimizadas=optimizadas
otimizado=optimizado
otimizados=optimizados
otimizai=optimizai
otimizais=optimizais
otimizam=optimizam
otimizamos=optimizamos
otimizámos=optimizámos
otimizando=optimizando
otimizar=optimizar
otimizara=optimizara
otimizará=optimizará
otimizaram=optimizaram
otimizáramos=optimizáramos
otimizarão=optimizarão
otimizaras=optimizaras
otimizarás=optimizarás
otimizardes=optimizardes
otimizarei=optimizarei
otimizareis=optimizareis
otimizáreis=optimizáreis
otimizarem=optimizarem
otimizaremos=optimizaremos
otimizares=optimizares
otimizaria=optimizaria
otimizariam=optimizariam
otimizaríamos=optimizaríamos
otimizarias=optimizarias
otimizaríeis=optimizaríeis
otimizarmos=optimizarmos
otimizas=optimizas
otimizasse=optimizasse
otimizásseis=optimizásseis
otimizassem=optimizassem
otimizássemos=optimizássemos
otimizasses=optimizasses
otimizaste=optimizaste
otimizastes=optimizastes
otimizava=optimizava
otimizavam=optimizavam
otimizávamos=optimizávamos
otimizavas=optimizavas
otimizáveis=optimizáveis
otimize=optimize
otimizei=optimizei
otimizeis=optimizeis
otimizem=optimizem
otimizemos=optimizemos
otimizes=optimizes
otimizo=optimizo
otimizou=optimizou
ótimo=óptimo
ótimos=óptimos
organolético=organoléptico
organoléticos=organolépticos
organotático=organotáctico
organotáticos=organotácticos
orquiopético=orquiopéctico
orquiopéticos=orquiopécticos
paleártica=paleárctica
paleárticas=paleárcticas
paleártico=paleárctico
paleárticos=paleárcticos
panótico=panóptico
panóticos=panópticos
para-brisas=pára-brisas
para-choque=pára-choque
para-choques=pára-choques
para-lamas=pára-lamas
paraquedas=pára-quedas
paraquedismo=pára-quedismo
paraquedista=pára-quedista
paraquedistas=pára-quedistas
para-raios=pára-raios
para-vento=pára-vento
# para=pára
paraelétrico=paraeléctrico
paraelétricos=paraeléctricos
paralaticamente=paralacticamente
paralático=paraláctico
paraláticos=paralácticos
paralético=paraléctico
paraléticos=paralécticos
parapético=parapéctico
parapéticos=parapécticos
paraplético=parapléctico
parapléticos=paraplécticos
parapoplético=parapopléctico
parapopléticos=parapoplécticos
paratático=paratáctico
paratáticos=paratácticos
parelétrico=pareléctrico
parelétricos=pareléctricos
parótico=paróptico
paróticos=parópticos
# pela=péla
# pelas=pélas
# pelo=pêlo
# pelos=pêlos
penatisseto=penatissecto
penatissetos=penatissectos
# pera=péra
# pera=pêra
# peras=péras
# peras=pêras
perceção=percepção
perceciona=percepciona
percecionada=percepcionada
percecionadas=percepcionadas
percecionado=percepcionado
percecionados=percepcionados
percecionai=percepcionai
percecionais=percepcionais
percecionam=percepcionam
percecionamos=percepcionamos
percecionámos=percepcionámos
percecionando=percepcionando
percecionar=percepcionar
percecionara=percepcionara
percecionará=percepcionará
percecionaram=percepcionaram
percecionáramos=percepcionáramos
percecionarão=percepcionarão
percecionaras=percepcionaras
percecionarás=percepcionarás
percecionardes=percepcionardes
percecionarei=percepcionarei
percecionareis=percepcionareis
percecionáreis=percepcionáreis
percecionarem=percepcionarem
percecionaremos=percepcionaremos
percecionares=percepcionares
percecionaria=percepcionaria
percecionariam=percepcionariam
percecionaríamos=percepcionaríamos
percecionarias=percepcionarias
percecionaríeis=percepcionaríeis
percecionarmos=percepcionarmos
percecionas=percepcionas
percecionasse=percepcionasse
percecionásseis=percepcionásseis
percecionassem=percepcionassem
percecionássemos=percepcionássemos
percecionasses=percepcionasses
percecionaste=percepcionaste
percecionastes=percepcionastes
percecionava=percepcionava
percecionavam=percepcionavam
percecionávamos=percepcionávamos
percecionavas=percepcionavas
percecionáveis=percepcionáveis
percecione=percepcione
percecionei=percepcionei
percecioneis=percepcioneis
percecionem=percepcionem
percecionemos=percepcionemos
perceciones=percepciones
percecionismo=percepcionismo
percecionismos=percepcionismos
percecionista=percepcionista
percecionistas=percepcionistas
perceciono=percepciono
percecionou=percepcionou
perceções=percepções
percetibilidade=perceptibilidade
percetibilidades=perceptibilidades
percetiva=perceptiva
percetivamente=perceptivamente
percetivas=perceptivas
percetíveis=perceptíveis
percetível=perceptível
percetivelmente=perceptivelmente
percetividade=perceptividade
percetividades=perceptividades
percetivo=perceptivo
percetivos=perceptivos
percetuais=perceptuais
percetual=perceptual
perenção=perempção
perenções=perempções
perento=perempto
perentória=peremptória
perentoriamente=peremptoriamente
perentórias=peremptórias
perentoriedade=peremptoriedade
perentoriedades=peremptoriedades
perentório=peremptório
perentórios=peremptórios
perentos=peremptos
perfecional=perfeccional
perfecionismo=perfeccionismo
perfecionista=perfeccionista
perfecionistas=perfeccionistas
perfetibilidade=perfectibilidade
perfetibilidades=perfectibilidades
perfetibiliza=perfectibiliza
perfetibilizada=perfectibilizada
perfetibilizadas=perfectibilizadas
perfetibilizado=perfectibilizado
perfetibilizados=perfectibilizados
perfetibilizai=perfectibilizai
perfetibilizais=perfectibilizais
perfetibilizam=perfectibilizam
perfetibilizamos=perfectibilizamos
perfetibilizámos=perfectibilizámos
perfetibilizando=perfectibilizando
perfetibilizar=perfectibilizar
perfetibilizara=perfectibilizara
perfetibilizará=perfectibilizará
perfetibilizaram=perfectibilizaram
perfetibilizáramos=perfectibilizáramos
perfetibilizarão=perfectibilizarão
perfetibilizaras=perfectibilizaras
perfetibilizarás=perfectibilizarás
perfetibilizardes=perfectibilizardes
perfetibilizarei=perfectibilizarei
perfetibilizareis=perfectibilizareis
perfetibilizáreis=perfectibilizáreis
perfetibilizarem=perfectibilizarem
perfetibilizaremos=perfectibilizaremos
perfetibilizares=perfectibilizares
perfetibilizaria=perfectibilizaria
perfetibilizariam=perfectibilizariam
perfetibilizaríamos=perfectibilizaríamos
perfetibilizarias=perfectibilizarias
perfetibilizaríeis=perfectibilizaríeis
perfetibilizarmos=perfectibilizarmos
perfetibilizas=perfectibilizas
perfetibilizasse=perfectibilizasse
perfetibilizásseis=perfectibilizásseis
perfetibilizassem=perfectibilizassem
perfetibilizássemos=perfectibilizássemos
perfetibilizasses=perfectibilizasses
perfetibilizaste=perfectibilizaste
perfetibilizastes=perfectibilizastes
perfetibilizava=perfectibilizava
perfetibilizavam=perfectibilizavam
perfetibilizávamos=perfectibilizávamos
perfetibilizavas=perfectibilizavas
perfetibilizáveis=perfectibilizáveis
perfetibilize=perfectibilize
perfetibilizei=perfectibilizei
perfetibilizeis=perfectibilizeis
perfetibilizem=perfectibilizem
perfetibilizemos=perfectibilizemos
perfetibilizes=perfectibilizes
perfetibilizo=perfectibilizo
perfetibilizou=perfectibilizou
perfetível=perfectível
perfetivo=perfectivo
perirretite=perirrectite
perirretites=perirrectites
pero=pêro
peros=pêros
perspético=perspéctico
perspéticos=perspécticos
perspetiva=perspectiva
perspetivação=perspectivação
perspetivações=perspectivações
perspetivada=perspectivada
perspetivadas=perspectivadas
perspetivado=perspectivado
perspetivados=perspectivados
perspetivai=perspectivai
perspetivais=perspectivais
perspetival=perspectival
perspetivam=perspectivam
perspetivamos=perspectivamos
perspetivámos=perspectivámos
perspetivando=perspectivando
perspetivar=perspectivar
perspetivara=perspectivara
perspetivará=perspectivará
perspetivaram=perspectivaram
perspetiváramos=perspectiváramos
perspetivarão=perspectivarão
perspetivaras=perspectivaras
perspetivarás=perspectivarás
perspetivardes=perspectivardes
perspetivarei=perspectivarei
perspetivareis=perspectivareis
perspetiváreis=perspectiváreis
perspetivarem=perspectivarem
perspetivaremos=perspectivaremos
perspetivares=perspectivares
perspetivaria=perspectivaria
perspetivariam=perspectivariam
perspetivaríamos=perspectivaríamos
perspetivarias=perspectivarias
perspetivaríeis=perspectivaríeis
perspetivarmos=perspectivarmos
perspetivas=perspectivas
perspetivasse=perspectivasse
perspetivásseis=perspectivásseis
perspetivassem=perspectivassem
perspetivássemos=perspectivássemos
perspetivasses=perspectivasses
perspetivaste=perspectivaste
perspetivastes=perspectivastes
perspetivava=perspectivava
perspetivavam=perspectivavam
perspetivávamos=perspectivávamos
perspetivavas=perspectivavas
perspetiváveis=perspectiváveis
perspetive=perspective
perspetivei=perspectivei
perspetiveis=perspectiveis
perspetivem=perspectivem
perspetivemos=perspectivemos
perspetives=perspectives
perspetividade=perspectividade
perspetividades=perspectividades
perspetivismo=perspectivismo
perspetivismos=perspectivismos
perspetivista=perspectivista
perspetivistas=perspectivistas
perspetivístico=perspectivístico
perspetivísticos=perspectivísticos
perspetivo=perspectivo
perspetivos=perspectivos
perspetivou=perspectivou
perspetográfico=perspectográfico
perspetográficos=perspectográficos
perspetógrafo=perspectógrafo
perspetógrafos=perspectógrafos
piezeletricidade=piezelectricidade
piezeletricidades=piezelectricidades
piezelétrico=piezeléctrico
piezelétricos=piezeléctricos
piezoeletricidade=piezoelectricidade
piezoeletricidades=piezoelectricidades
piezoelétrico=piezoeléctrico
piezoelétricos=piezoeléctricos
pireletricidade=pirelectricidade
pireletricidades=pirelectricidades
pirelétrico=pireléctrico
pirelétricos=pireléctricos
piroeletricidade=piroelectricidade
piroeletricidades=piroelectricidades
piroelétrico=piroeléctrico
piroelétricos=piroeléctricos
plasmorrético=plasmorréctico
plasmorréticos=plasmorrécticos
pluriatividade=pluriactividade
pluriatividades=pluriactividades
pneumopético=pneumopéctico
pneumopéticos=pneumopécticos
pneumoplético=pneumopléctico
pneumopléticos=pneumoplécticos
polipletro=poliplectro
polipletros=poliplectros
polo=pólo
polos=pólos
pré-seleção=pré-selecção
pré-seleciona=pré-selecciona
pré-selecionada=pré-seleccionada
pré-selecionadas=pré-seleccionadas
pré-selecionado=pré-seleccionado
pré-selecionador=pré-seleccionador
pré-selecionadora=pré-seleccionadora
pré-selecionadoras=pré-seleccionadoras
pré-selecionadores=pré-seleccionadores
pré-selecionados=pré-seleccionados
pré-selecionai=pré-seleccionai
pré-selecionais=pré-seleccionais
pré-selecionam=pré-seleccionam
pré-selecionamos=pré-seleccionamos
pré-selecionámos=pré-seleccionámos
pré-selecionando=pré-seleccionando
pré-selecionar=pré-seleccionar
pré-selecionara=pré-seleccionara
pré-selecionará=pré-seleccionará
pré-selecionaram=pré-seleccionaram
pré-selecionáramos=pré-seleccionáramos
pré-selecionarão=pré-seleccionarão
pré-selecionaras=pré-seleccionaras
pré-selecionarás=pré-seleccionarás
pré-selecionardes=pré-seleccionardes
pré-selecionarei=pré-seleccionarei
pré-selecionareis=pré-seleccionareis
pré-selecionáreis=pré-seleccionáreis
pré-selecionarem=pré-seleccionarem
pré-selecionaremos=pré-seleccionaremos
pré-selecionares=pré-seleccionares
pré-selecionaria=pré-seleccionaria
pré-selecionariam=pré-seleccionariam
pré-selecionaríamos=pré-seleccionaríamos
pré-selecionarias=pré-seleccionarias
pré-selecionaríeis=pré-seleccionaríeis
pré-selecionarmos=pré-seleccionarmos
pré-selecionas=pré-seleccionas
pré-selecionasse=pré-seleccionasse
pré-selecionásseis=pré-seleccionásseis
pré-selecionassem=pré-seleccionassem
pré-selecionássemos=pré-seleccionássemos
pré-selecionasses=pré-seleccionasses
pré-selecionaste=pré-seleccionaste
pré-selecionastes=pré-seleccionastes
pré-selecionava=pré-seleccionava
pré-selecionavam=pré-seleccionavam
pré-selecionávamos=pré-seleccionávamos
pré-selecionavas=pré-seleccionavas
pré-selecionáveis=pré-seleccionáveis
pré-selecionável=pré-seleccionável
pré-selecione=pré-seleccione
pré-selecionei=pré-seleccionei
pré-selecioneis=pré-seleccioneis
pré-selecionem=pré-seleccionem
pré-selecionemos=pré-seleccionemos
pré-seleciones=pré-selecciones
pré-seleciono=pré-selecciono
pré-selecionou=pré-seleccionou
pré-seleções=pré-selecções
precetor=preceptor
precetora=preceptora
precetorado=preceptorado
precetoral=preceptoral
precetoras=preceptoras
precetores=preceptores
precetoria=preceptoria
precetorial=preceptorial
preconceção=preconcepção
preconceções=preconcepções
preconcetivo=preconceptivo
preconcetivos=preconceptivos
predileção=predilecção
predileções=predilecções
predileta=predilecta
prediletamente=predilectamente
prediletas=predilectas
predileto=predilecto
prediletos=predilectos
preleção=prelecção
prelecionador=preleccionador
prelecionadores=preleccionadores
prelecionar=preleccionar
prelecionares=preleccionares
prelecionista=preleccionista
prelecionistas=preleccionistas
preleções=prelecções
preletor=prelector
preletorado=prelectorado
preletorados=prelectorados
preletores=prelectores
procatalético=procataléptico
procataléticos=procatalépticos
proctopético=proctopéctico
proctopéticos=proctopécticos
profilaticamente=profilacticamente
profilático=profiláctico
profiláticos=profilácticos
profilatismo=profilactismo
profilatismos=profilactismos
projeção=projecção
projecionais=projeccionais
projecional=projeccional
projecionista=projeccionista
projecionistas=projeccionistas
projeções=projecções
projeta=projecta
projetação=projectação
projetações=projectações
projetada=projectada
projetadas=projectadas
projetado=projectado
projetador=projectador
projetadores=projectadores
projetados=projectados
projetai=projectai
projetais=projectais
projetam=projectam
projetamos=projectamos
projetámos=projectámos
projetando=projectando
projetante=projectante
projetantes=projectantes
projetar=projectar
projetara=projectara
projetará=projectará
projetaram=projectaram
projetáramos=projectáramos
projetarão=projectarão
projetaras=projectaras
projetarás=projectarás
projetardes=projectardes
projetarei=projectarei
projetareis=projectareis
projetáreis=projectáreis
projetarem=projectarem
projetaremos=projectaremos
projetares=projectares
projetaria=projectaria
projetariam=projectariam
projetaríamos=projectaríamos
projetarias=projectarias
projetaríeis=projectaríeis
projetarmos=projectarmos
projetas=projectas
projetasse=projectasse
projetásseis=projectásseis
projetassem=projectassem
projetássemos=projectássemos
projetasses=projectasses
projetaste=projectaste
projetastes=projectastes
projetava=projectava
projetavam=projectavam
projetávamos=projectávamos
projetavas=projectavas
projetáveis=projectáveis
projetável=projectável
projete=projecte
projetei=projectei
projeteis=projecteis
projéteis=projécteis
projetem=projectem
projetemos=projectemos
projetes=projectes
projetício=projectício
projetícios=projectícios
projétil=projéctil
projétis=projéctis
projetista=projectista
projetistas=projectistas
projetiva=projectiva
projetivas=projectivas
projetivo=projectivo
projetivos=projectivos
projeto-lei=projecto-lei
projeto=projecto
projetográfico=projectográfico
projetográficos=projectográficos
projetógrafo=projectógrafo
projetógrafos=projectógrafos
projetor=projector
projetores=projectores
projetos=projectos
projetoscópico=projectoscópico
projetoscópicos=projectoscópicos
projetou=projectou
projetura=projectura
projeturas=projecturas
prolético=proléctico
proléticos=prolécticos
proleticamente=prolepticamente
propriocetivo=proprioceptivo
propriocetivos=proprioceptivos
propriocetor=proprioceptor
propriocetores=proprioceptores
prospeção=prospecção
prospeções=prospecções
prospeta=prospecta
prospetada=prospectada
prospetadas=prospectadas
prospetado=prospectado
prospetados=prospectados
prospetai=prospectai
prospetais=prospectais
prospetam=prospectam
prospetamos=prospectamos
prospetámos=prospectámos
prospetando=prospectando
prospetar=prospectar
prospetara=prospectara
prospetará=prospectará
prospetaram=prospectaram
prospetáramos=prospectáramos
prospetarão=prospectarão
prospetaras=prospectaras
prospetarás=prospectarás
prospetardes=prospectardes
prospetarei=prospectarei
prospetareis=prospectareis
prospetáreis=prospectáreis
prospetarem=prospectarem
prospetaremos=prospectaremos
prospetares=prospectares
prospetaria=prospectaria
prospetariam=prospectariam
prospetaríamos=prospectaríamos
prospetarias=prospectarias
prospetaríeis=prospectaríeis
prospetarmos=prospectarmos
prospetas=prospectas
prospetasse=prospectasse
prospetásseis=prospectásseis
prospetassem=prospectassem
prospetássemos=prospectássemos
prospetasses=prospectasses
prospetaste=prospectaste
prospetastes=prospectastes
prospetava=prospectava
prospetavam=prospectavam
prospetávamos=prospectávamos
prospetavas=prospectavas
prospetáveis=prospectáveis
prospete=prospecte
prospetei=prospectei
prospeteis=prospecteis
prospetem=prospectem
prospetemos=prospectemos
prospetes=prospectes
prospetiva=prospectiva
prospetivas=prospectivas
prospetivo=prospectivo
prospetivos=prospectivos
prospeto=prospecto
prospetor=prospector
prospetora=prospectora
prospetoras=prospectoras
prospetores=prospectores
prospetos=prospectos
prospetou=prospectou
prostatopético=prostatopéctico
prostatopéticos=prostatopécticos
proteção=protecção
protecionais=proteccionais
protecional=proteccional
protecionismo=proteccionismo
protecionismos=proteccionismos
protecionista=proteccionista
protecionistas=proteccionistas
proteções=protecções
protetivo=protectivo
protetivos=protectivos
protetor=protector
protetora=protectora
protetorado=protectorado
protetorados=protectorados
protetorais=protectorais
protetoral=protectoral
protetoras=protectoras
protetorato=protectorato
protetoratos=protectoratos
protetores=protectores
protetoria=protectoria
protetorias=protectorias
protetório=protectório
protetórios=protectórios
pseudobatizado=pseudobaptizado
pseudobatizados=pseudobaptizados
pseudodialetais=pseudodialectais
pseudodialetal=pseudodialectal
pseudorrético=pseudorréctico
pseudorréticos=pseudorrécticos
psicoativo=psicoactivo
psicoativos=psicoactivos
pulsorreator=pulsorreactor
pulsorreatores=pulsorreactores
puntiforme=punctiforme
puntiformes=punctiformes
puntura=punctura
punturas=puncturas
putrefação=putrefacção
putrefações=putrefacções
putrefativo=putrefactivo
putrefator=putrefactor
putrefatores=putrefactores
putrefatório=putrefactório
putrefatórios=putrefactórios
quadrirreator=quadrirreactor
quadrirreatores=quadrirreactores
quimiorreceção=quimiorrecepção
quimiorreceções=quimiorrecepções
quimiorrecetividade=quimiorreceptividade
quimiorrecetividades=quimiorreceptividades
quimiorrecetivo=quimiorreceptivo
quimiorrecetivos=quimiorreceptivos
quimiorrecetor=quimiorreceptor
quimiorrecetores=quimiorreceptores
quimiotático=quimiotáctico
quimiotáticos=quimiotácticos
radiatividade=radiactividade
radiatividades=radiactividades
radiativo=radiactivo
radiativos=radiactivos
radieletricidade=radielectricidade
radieletricidades=radielectricidades
radielétrico=radieléctrico
radielétricos=radieléctricos
radioativa=radioactiva
radioativas=radioactivas
radioatividade=radioactividade
radioatividades=radioactividades
radioativo=radioactivo
radioativos=radioactivos
radioeletricidade=radioelectricidade
radioeletricidades=radioelectricidades
radioelétrico=radioeléctrico
radioelétricos=radioeléctricos
radioeletrónico=radioelectrónico
radioeletrónicos=radioelectrónicos
radiorrecetor=radiorreceptor
radiorrecetores=radiorreceptores
rarefação=rarefacção
rarefações=rarefacções
rarefatível=rarefactível
rarefativo=rarefactivo
rarefator=rarefactor
rarefatores=rarefactores
reação=reacção
reacionais=reaccionais
reacional=reaccional
reacionária=reaccionária
reacionariamente=reaccionariamente
reacionárias=reaccionárias
reacionário=reaccionário
reacionários=reaccionários
reacionarismo=reaccionarismo
reacionarismos=reaccionarismos
reacionarista=reaccionarista
reacionaristas=reaccionaristas
reacionismo=reaccionismo
reacionismos=reaccionismos
reacionista=reaccionista
reacionistas=reaccionistas
reações=reacções
reativa=reactiva
reativação=reactivação
reativações=reactivações
reativada=reactivada
reativadas=reactivadas
reativado=reactivado
reativador=reactivador
reativadora=reactivadora
reativadoras=reactivadoras
reativadores=reactivadores
reativados=reactivados
reativai=reactivai
reativais=reactivais
reativam=reactivam
reativamos=reactivamos
reativámos=reactivámos
reativando=reactivando
reativante=reactivante
reativantes=reactivantes
reativar=reactivar
reativara=reactivara
reativará=reactivará
reativaram=reactivaram
reativáramos=reactiváramos
reativarão=reactivarão
reativaras=reactivaras
reativarás=reactivarás
reativardes=reactivardes
reativarei=reactivarei
reativareis=reactivareis
reativáreis=reactiváreis
reativarem=reactivarem
reativaremos=reactivaremos
reativares=reactivares
reativaria=reactivaria
reativariam=reactivariam
reativaríamos=reactivaríamos
reativarias=reactivarias
reativaríeis=reactivaríeis
reativarmos=reactivarmos
reativas=reactivas
reativasse=reactivasse
reativásseis=reactivásseis
reativassem=reactivassem
reativássemos=reactivássemos
reativasses=reactivasses
reativaste=reactivaste
reativastes=reactivastes
reativava=reactivava
reativavam=reactivavam
reativávamos=reactivávamos
reativavas=reactivavas
reativáveis=reactiváveis
reative=reactive
reativei=reactivei
reativeis=reactiveis
reativem=reactivem
reativemos=reactivemos
reatives=reactives
reatividade=reactividade
reatividades=reactividades
reativo=reactivo
reativos=reactivos
reativou=reactivou
reator=reactor
reatores=reactores
reatualiza=reactualiza
reatualização=reactualização
reatualizações=reactualizações
reatualizada=reactualizada
reatualizadas=reactualizadas
reatualizado=reactualizado
reatualizador=reactualizador
reatualizadora=reactualizadora
reatualizadoras=reactualizadoras
reatualizadores=reactualizadores
reatualizados=reactualizados
reatualizai=reactualizai
reatualizais=reactualizais
reatualizam=reactualizam
reatualizamos=reactualizamos
reatualizámos=reactualizámos
reatualizando=reactualizando
reatualizar=reactualizar
reatualizara=reactualizara
reatualizará=reactualizará
reatualizaram=reactualizaram
reatualizáramos=reactualizáramos
reatualizarão=reactualizarão
reatualizaras=reactualizaras
reatualizarás=reactualizarás
reatualizardes=reactualizardes
reatualizarei=reactualizarei
reatualizareis=reactualizareis
reatualizáreis=reactualizáreis
reatualizarem=reactualizarem
reatualizaremos=reactualizaremos
reatualizares=reactualizares
reatualizaria=reactualizaria
reatualizariam=reactualizariam
reatualizaríamos=reactualizaríamos
reatualizarias=reactualizarias
reatualizaríeis=reactualizaríeis
reatualizarmos=reactualizarmos
reatualizas=reactualizas
reatualizasse=reactualizasse
reatualizásseis=reactualizásseis
reatualizassem=reactualizassem
reatualizássemos=reactualizássemos
reatualizasses=reactualizasses
reatualizaste=reactualizaste
reatualizastes=reactualizastes
reatualizava=reactualizava
reatualizavam=reactualizavam
reatualizávamos=reactualizávamos
reatualizavas=reactualizavas
reatualizáveis=reactualizáveis
reatualizável=reactualizável
reatualize=reactualize
reatualizei=reactualizei
reatualizeis=reactualizeis
reatualizem=reactualizem
reatualizemos=reactualizemos
reatualizes=reactualizes
reatualizo=reactualizo
reatualizou=reactualizou
readoção=readopção
readoções=readopções
readota=readopta
readotada=readoptada
readotadas=readoptadas
readotado=readoptado
readotados=readoptados
readotai=readoptai
readotais=readoptais
readotam=readoptam
readotamos=readoptamos
readotámos=readoptámos
readotando=readoptando
readotante=readoptante
readotantes=readoptantes
readotar=readoptar
readotara=readoptara
readotará=readoptará
readotaram=readoptaram
readotáramos=readoptáramos
readotarão=readoptarão
readotaras=readoptaras
readotarás=readoptarás
readotardes=readoptardes
readotarei=readoptarei
readotareis=readoptareis
readotáreis=readoptáreis
readotarem=readoptarem
readotaremos=readoptaremos
readotares=readoptares
readotaria=readoptaria
readotariam=readoptariam
readotaríamos=readoptaríamos
readotarias=readoptarias
readotaríeis=readoptaríeis
readotarmos=readoptarmos
readotas=readoptas
readotasse=readoptasse
readotásseis=readoptásseis
readotassem=readoptassem
readotássemos=readoptássemos
readotasses=readoptasses
readotaste=readoptaste
readotastes=readoptastes
readotava=readoptava
readotavam=readoptavam
readotávamos=readoptávamos
readotavas=readoptavas
readotáveis=readoptáveis
readote=readopte
readotei=readoptei
readoteis=readopteis
readotem=readoptem
readotemos=readoptemos
readotes=readoptes
readoto=readopto
readotou=readoptou
reafeta=reafecta
reafetação=reafectação
reafetações=reafectações
reafetada=reafectada
reafetadamente=reafectadamente
reafetadas=reafectadas
reafetado=reafectado
reafetados=reafectados
reafetai=reafectai
reafetais=reafectais
reafetam=reafectam
reafetamos=reafectamos
reafetámos=reafectámos
reafetando=reafectando
reafetante=reafectante
reafetantes=reafectantes
reafetar=reafectar
reafetara=reafectara
reafetará=reafectará
reafetaram=reafectaram
reafetáramos=reafectáramos
reafetarão=reafectarão
reafetaras=reafectaras
reafetarás=reafectarás
reafetardes=reafectardes
reafetarei=reafectarei
reafetareis=reafectareis
reafetáreis=reafectáreis
reafetarem=reafectarem
reafetaremos=reafectaremos
reafetares=reafectares
reafetaria=reafectaria
reafetariam=reafectariam
reafetaríamos=reafectaríamos
reafetarias=reafectarias
reafetaríeis=reafectaríeis
reafetarmos=reafectarmos
reafetas=reafectas
reafetasse=reafectasse
reafetásseis=reafectásseis
reafetassem=reafectassem
reafetássemos=reafectássemos
reafetasses=reafectasses
reafetaste=reafectaste
reafetastes=reafectastes
reafetava=reafectava
reafetavam=reafectavam
reafetávamos=reafectávamos
reafetavas=reafectavas
reafetáveis=reafectáveis
reafete=reafecte
reafetei=reafectei
reafeteis=reafecteis
reafetem=reafectem
reafetemos=reafectemos
reafetes=reafectes
reafeto=reafecto
reafetou=reafectou
rebatismo=rebaptismo
rebatismos=rebaptismos
rebatiza=rebaptiza
rebatizada=rebaptizada
rebatizadas=rebaptizadas
rebatizado=rebaptizado
rebatizados=rebaptizados
rebatizai=rebaptizai
rebatizais=rebaptizais
rebatizam=rebaptizam
rebatizamos=rebaptizamos
rebatizámos=rebaptizámos
rebatizando=rebaptizando
rebatizar=rebaptizar
rebatizara=rebaptizara
rebatizará=rebaptizará
rebatizaram=rebaptizaram
rebatizáramos=rebaptizáramos
rebatizarão=rebaptizarão
rebatizaras=rebaptizaras
rebatizarás=rebaptizarás
rebatizardes=rebaptizardes
rebatizarei=rebaptizarei
rebatizareis=rebaptizareis
rebatizáreis=rebaptizáreis
rebatizarem=rebaptizarem
rebatizaremos=rebaptizaremos
rebatizares=rebaptizares
rebatizaria=rebaptizaria
rebatizariam=rebaptizariam
rebatizaríamos=rebaptizaríamos
rebatizarias=rebaptizarias
rebatizaríeis=rebaptizaríeis
rebatizarmos=rebaptizarmos
rebatizas=rebaptizas
rebatizasse=rebaptizasse
rebatizásseis=rebaptizásseis
rebatizassem=rebaptizassem
rebatizássemos=rebaptizássemos
rebatizasses=rebaptizasses
rebatizaste=rebaptizaste
rebatizastes=rebaptizastes
rebatizava=rebaptizava
rebatizavam=rebaptizavam
rebatizávamos=rebaptizávamos
rebatizavas=rebaptizavas
rebatizáveis=rebaptizáveis
rebatize=rebaptize
rebatizei=rebaptizei
rebatizeis=rebaptizeis
rebatizem=rebaptizem
rebatizemos=rebaptizemos
rebatizes=rebaptizes
rebatizo=rebaptizo
rebatizou=rebaptizou
receção=recepção
rececionado=recepcionado
rececionados=recepcionados
rececionamento=recepcionamento
rececionamentos=recepcionamentos
rececionante=recepcionante
rececionantes=recepcionantes
rececionar=recepcionar
rececionares=recepcionares
rececionáveis=recepcionáveis
rececionável=recepcionável
rececionista=recepcionista
rececionistas=recepcionistas
receções=recepções
receta=recepta
recetação=receptação
recetações=receptações
recetacular=receptacular
recetaculares=receptaculares
recetáculo=receptáculo
recetáculos=receptáculos
recetada=receptada
recetadas=receptadas
recetado=receptado
recetador=receptador
recetadora=receptadora
recetadoras=receptadoras
recetadores=receptadores
recetados=receptados
recetai=receptai
recetais=receptais
recetam=receptam
recetamos=receptamos
recetámos=receptámos
recetando=receptando
recetar=receptar
recetara=receptara
recetará=receptará
recetaram=receptaram
recetáramos=receptáramos
recetarão=receptarão
recetaras=receptaras
recetarás=receptarás
recetardes=receptardes
recetarei=receptarei
recetareis=receptareis
recetáreis=receptáreis
recetarem=receptarem
recetaremos=receptaremos
recetares=receptares
recetaria=receptaria
recetariam=receptariam
recetaríamos=receptaríamos
recetarias=receptarias
recetaríeis=receptaríeis
recetarmos=receptarmos
recetas=receptas
recetasse=receptasse
recetásseis=receptásseis
recetassem=receptassem
recetássemos=receptássemos
recetasses=receptasses
recetaste=receptaste
recetastes=receptastes
recetava=receptava
recetavam=receptavam
recetávamos=receptávamos
recetavas=receptavas
recetáveis=receptáveis
recete=recepte
recetei=receptei
receteis=recepteis
recetem=receptem
recetemos=receptemos
recetes=receptes
recetibilidade=receptibilidade
recetibilidades=receptibilidades
recetiva=receptiva
recetivas=receptivas
recetíveis=receptíveis
recetível=receptível
recetividade=receptividade
recetividades=receptividades
recetivo=receptivo
recetivos=receptivos
receto=recepto
recetor=receptor
recetora=receptora
recetoras=receptoras
recetores=receptores
recetou=receptou
recoleção=recolecção
recoleções=recolecções
recoleta=recolecta
recoletas=recolectas
recoleto=recolecto
recoletor=recolector
recoletora=recolectora
recoletoras=recolectoras
recoletores=recolectores
recoletos=recolectos
recorreção=recorrecção
recorreções=recorrecções
reta=recta
retal=rectal
retalgia=rectalgia
retalgias=rectalgias
retamente=rectamente
retangular=rectangular
retangulares=rectangulares
retangularidade=rectangularidade
retangularidades=rectangularidades
retangularmente=rectangularmente
retângulo=rectângulo
retângulos=rectângulos
retas=rectas
reticórneo=recticórneo
reticórneos=recticórneos
retidão=rectidão
retidões=rectidões
retifica=rectifica
retificação=rectificação
retificações=rectificações
retificada=rectificada
retificadas=rectificadas
retificado=rectificado
retificador=rectificador
retificadora=rectificadora
retificadoras=rectificadoras
retificadores=rectificadores
retificados=rectificados
retificai=rectificai
retificais=rectificais
retificam=rectificam
retificamos=rectificamos
retificámos=rectificámos
retificando=rectificando
retificar=rectificar
retificara=rectificara
retificará=rectificará
retificaram=rectificaram
retificáramos=rectificáramos
retificarão=rectificarão
retificaras=rectificaras
retificarás=rectificarás
retificardes=rectificardes
retificarei=rectificarei
retificareis=rectificareis
retificáreis=rectificáreis
retificarem=rectificarem
retificaremos=rectificaremos
retificares=rectificares
retificaria=rectificaria
retificariam=rectificariam
retificaríamos=rectificaríamos
retificarias=rectificarias
retificaríeis=rectificaríeis
retificarmos=rectificarmos
retificas=rectificas
retificasse=rectificasse
retificásseis=rectificásseis
retificassem=rectificassem
retificássemos=rectificássemos
retificasses=rectificasses
retificaste=rectificaste
retificastes=rectificastes
retificativo=rectificativo
retificativos=rectificativos
retificava=rectificava
retificavam=rectificavam
retificávamos=rectificávamos
retificavas=rectificavas
retificáveis=rectificáveis
retificável=rectificável
retifico=rectifico
retificou=rectificou
retifique=rectifique
retifiquei=rectifiquei
retifiqueis=rectifiqueis
retifiquem=rectifiquem
retifiquemos=rectifiquemos
retifiques=rectifiques
retifloro=rectifloro
retifloros=rectifloros
retiforme=rectiforme
retiformes=rectiformes
retígrado=rectígrado
retígrados=rectígrados
retilínea=rectilínea
retilineamente=rectilineamente
retilinearidade=rectilinearidade
retilinearidades=rectilinearidades
retilíneas=rectilíneas
retilíneo=rectilíneo
retilíneos=rectilíneos
retinérveo=rectinérveo
retinérveos=rectinérveos
retiparalelinérveo=rectiparalelinérveo
retiparalelinérveos=rectiparalelinérveos
retirrostro=rectirrostro
retirrostros=rectirrostros
retite=rectite
retites=rectites
retitude=rectitude
retitudes=rectitudes
reto=recto
retocele=rectocele
retoceles=rectoceles
retococcígeo=rectococcígeo
retococcígeos=rectococcígeos
retocolite=rectocolite
retocolites=rectocolites
retopético=rectopéctico
retopéticos=rectopécticos
retopexia=rectopexia
retopexias=rectopexias
retor=rector
retores=rectores
retos=rectos
retoscopia=rectoscopia
retoscopias=rectoscopias
retoscópico=rectoscópico
retoscópicos=rectoscópicos
retoscópio=rectoscópio
retoscópios=rectoscópios
retotomia=rectotomia
retotomias=rectotomias
retotómico=rectotómico
retotómicos=rectotómicos
retovaginais=rectovaginais
retovaginal=rectovaginal
retovesicais=rectovesicais
retovesical=rectovesical
retriciais=rectriciais
retricial=rectricial
retriz=rectriz
retrizs=rectrizs
returetrais=recturetrais
returetral=recturetral
redação=redacção
redações=redacções
redator-chefe=redactor-chefe
redator=redactor
redatora=redactora
redatoras=redactoras
redatores=redactores
redatoriais=redactoriais
redatorial=redactorial
redireciona=redirecciona
redirecionada=redireccionada
redirecionadas=redireccionadas
redirecionado=redireccionado
redirecionados=redireccionados
redirecionai=redireccionai
redirecionais=redireccionais
redirecionam=redireccionam
redirecionamento=redireccionamento
redirecionamentos=redireccionamentos
redirecionamos=redireccionamos
redirecionámos=redireccionámos
redirecionando=redireccionando
redirecionar=redireccionar
redirecionara=redireccionara
redirecionará=redireccionará
redirecionaram=redireccionaram
redirecionáramos=redireccionáramos
redirecionarão=redireccionarão
redirecionaras=redireccionaras
redirecionarás=redireccionarás
redirecionardes=redireccionardes
redirecionarei=redireccionarei
redirecionareis=redireccionareis
redirecionáreis=redireccionáreis
redirecionarem=redireccionarem
redirecionaremos=redireccionaremos
redirecionares=redireccionares
redirecionaria=redireccionaria
redirecionariam=redireccionariam
redirecionaríamos=redireccionaríamos
redirecionarias=redireccionarias
redirecionaríeis=redireccionaríeis
redirecionarmos=redireccionarmos
redirecionas=redireccionas
redirecionasse=redireccionasse
redirecionásseis=redireccionásseis
redirecionassem=redireccionassem
redirecionássemos=redireccionássemos
redirecionasses=redireccionasses
redirecionaste=redireccionaste
redirecionastes=redireccionastes
redirecionava=redireccionava
redirecionavam=redireccionavam
redirecionávamos=redireccionávamos
redirecionavas=redireccionavas
redirecionáveis=redireccionáveis
redirecione=redireccione
redirecionei=redireccionei
redirecioneis=redireccioneis
redirecionem=redireccionem
redirecionemos=redireccionemos
redireciones=redirecciones
redireciono=redirecciono
redirecionou=redireccionou
reeletrómetro=reelectrómetro
reeletrómetros=reelectrómetros
refetivo=refectivo
refetivos=refectivos
refetório=refectório
refetórios=refectórios
refleti=reflecti
refletia=reflectia
refletiam=reflectiam
refletíamos=reflectíamos
refletias=reflectias
refletida=reflectida
refletidamente=reflectidamente
refletidas=reflectidas
refletido=reflectido
refletidor=reflectidor
refletidora=reflectidora
refletidoras=reflectidoras
refletidores=reflectidores
refletidos=reflectidos
refletíeis=reflectíeis
refletimos=reflectimos
refletindo=reflectindo
refletir=reflectir
refletira=reflectira
refletirá=reflectirá
refletiram=reflectiram
refletíramos=reflectíramos
refletirão=reflectirão
refletiras=reflectiras
refletirás=reflectirás
refletirdes=reflectirdes
refletirei=reflectirei
refletireis=reflectireis
refletíreis=reflectíreis
refletirem=reflectirem
refletiremos=reflectiremos
refletires=reflectires
refletiria=reflectiria
refletiriam=reflectiriam
refletiríamos=reflectiríamos
refletirias=reflectirias
refletiríeis=reflectiríeis
refletirmos=reflectirmos
refletisse=reflectisse
refletísseis=reflectísseis
refletissem=reflectissem
refletíssemos=reflectíssemos
refletisses=reflectisses
refletiste=reflectiste
refletistes=reflectistes
refletiu=reflectiu
refletividade=reflectividade
refletividades=reflectividades
refletivo=reflectivo
refletivos=reflectivos
refletor=reflector
refletora=reflectora
refletoras=reflectoras
refletores=reflectores
refração=refracção
refrações=refracções
refrata=refracta
refratada=refractada
refratadas=refractadas
refratado=refractado
refratados=refractados
refratai=refractai
refratais=refractais
refratam=refractam
refratamos=refractamos
refratámos=refractámos
refratando=refractando
refratar=refractar
refratara=refractara
refratará=refractará
refrataram=refractaram
refratáramos=refractáramos
refratarão=refractarão
refrataras=refractaras
refratarás=refractarás
refratardes=refractardes
refratarei=refractarei
refratareis=refractareis
refratáreis=refractáreis
refratarem=refractarem
refrataremos=refractaremos
refratares=refractares
refrataria=refractaria
refratária=refractária
refratariam=refractariam
refratariamente=refractariamente
refrataríamos=refractaríamos
refratarias=refractarias
refratárias=refractárias
refrataríeis=refractaríeis
refratário=refractário
refratários=refractários
refratarismo=refractarismo
refratarismos=refractarismos
refratarmos=refractarmos
refratas=refractas
refratasse=refractasse
refratásseis=refractásseis
refratassem=refractassem
refratássemos=refractássemos
refratasses=refractasses
refrataste=refractaste
refratastes=refractastes
refratava=refractava
refratavam=refractavam
refratávamos=refractávamos
refratavas=refractavas
refratáveis=refractáveis
refrate=refracte
refratei=refractei
refrateis=refracteis
refratem=refractem
refratemos=refractemos
refrates=refractes
refratismo=refractismo
refratismos=refractismos
refrativa=refractiva
refrativas=refractivas
refratividade=refractividade
refratividades=refractividades
refrativo=refractivo
refrativos=refractivos
refrato=refracto
refratometria=refractometria
refratometrias=refractometrias
refratométrico=refractométrico
refratométricos=refractométricos
refratómetro=refractómetro
refratómetros=refractómetros
refrator=refractor
refratores=refractores
refratos=refractos
refratoscópico=refractoscópico
refratoscópicos=refractoscópicos
refratoscópio=refractoscópio
refratoscópios=refractoscópios
refratou=refractou
regioletais=regiolectais
regioletal=regiolectal
regioleto=regiolecto
regioletos=regiolectos
reida=réida
reidas=réidas
reinfeção=reinfecção
reinfeções=reinfecções
reotático=reotáctico
reotáticos=reotácticos
respetiva=respectiva
respetivamente=respectivamente
respetivas=respectivas
respetivo=respectivo
respetivos=respectivos
ressurrecionais=ressurreccionais
ressurrecional=ressurreccional
ressurrecionismo=ressurreccionismo
ressurrecionismos=ressurreccionismos
ressurrecionista=ressurreccionista
ressurrecionistas=ressurreccionistas
ressurreto=ressurrecto
ressurretos=ressurrectos
retração=retracção
retrações=retracções
retrata=retracta
retratação=retractação
retratações=retractações
retratada=retractada
retratadas=retractadas
retratado=retractado
retratados=retractados
retratai=retractai
retratais=retractais
retratam=retractam
retratamos=retractamos
retratámos=retractámos
retratando=retractando
retratar=retractar
retratara=retractara
retratará=retractará
retrataram=retractaram
retratáramos=retractáramos
retratarão=retractarão
retrataras=retractaras
retratarás=retractarás
retratardes=retractardes
retratarei=retractarei
retratareis=retractareis
retratáreis=retractáreis
retratarem=retractarem
retrataremos=retractaremos
retratares=retractares
retrataria=retractaria
retratariam=retractariam
retrataríamos=retractaríamos
retratarias=retractarias
retrataríeis=retractaríeis
retratarmos=retractarmos
retratas=retractas
retratasse=retractasse
retratásseis=retractásseis
retratassem=retractassem
retratássemos=retractássemos
retratasses=retractasses
retrataste=retractaste
retratastes=retractastes
retratava=retractava
retratavam=retractavam
retratávamos=retractávamos
retratavas=retractavas
retratáveis=retractáveis
retratável=retractável
retrate=retracte
retratei=retractei
retrateis=retracteis
retratem=retractem
retratemos=retractemos
retrates=retractes
retrátil=retráctil
retratilidade=retractilidade
retratilidades=retractilidades
retrativo=retractivo
retrato=retracto
retratou=retractou
retroação=retroacção
retroações=retroacções
retroativa=retroactiva
retroativamente=retroactivamente
retroativas=retroactivas
retroatividade=retroactividade
retroatividades=retroactividades
retroativo=retroactivo
retroativos=retroactivos
retroator=retroactor
retroatores=retroactores
retrofletida=retroflectida
retrofletidas=retroflectidas
retrofletido=retroflectido
retrofletidos=retroflectidos
retrofletir=retroflectir
retrofletires=retroflectires
retroprojeção=retroprojecção
retroprojeções=retroprojecções
retroprojetar=retroprojectar
retroprojetares=retroprojectares
retroprojetor=retroprojector
retroprojetores=retroprojectores
retrospeção=retrospecção
retrospeções=retrospecções
retrospetiva=retrospectiva
retrospetivamente=retrospectivamente
retrospetivas=retrospectivas
retrospetividade=retrospectividade
retrospetividades=retrospectividades
retrospetivo=retrospectivo
retrospetivos=retrospectivos
retrospeto=retrospecto
retrospetos=retrospectos
retrotração=retrotracção
retrotrações=retrotracções
rícia=ríccia
riciáceas=ricciáceas
rícias=ríccias
rinenfrático=rinenfráctico
rinenfráticos=rinenfrácticos
rizotático=rizotáctico
rizotáticos=rizotácticos
rubefação=rubefacção
rubefações=rubefacções
rutura=ruptura
ruturas=rupturas
seleção=selecção
seleciona=selecciona
selecionada=seleccionada
selecionadas=seleccionadas
selecionado=seleccionado
selecionador=seleccionador
selecionadora=seleccionadora
selecionadoras=seleccionadoras
selecionadores=seleccionadores
selecionados=seleccionados
selecionai=seleccionai
selecionais=seleccionais
selecionam=seleccionam
selecionamento=seleccionamento
selecionamentos=seleccionamentos
selecionamos=seleccionamos
selecionámos=seleccionámos
selecionando=seleccionando
selecionar=seleccionar
selecionara=seleccionara
selecionará=seleccionará
selecionaram=seleccionaram
selecionáramos=seleccionáramos
selecionarão=seleccionarão
selecionaras=seleccionaras
selecionarás=seleccionarás
selecionardes=seleccionardes
selecionarei=seleccionarei
selecionareis=seleccionareis
selecionáreis=seleccionáreis
selecionarem=seleccionarem
selecionaremos=seleccionaremos
selecionares=seleccionares
selecionaria=seleccionaria
selecionariam=seleccionariam
selecionaríamos=seleccionaríamos
selecionarias=seleccionarias
selecionaríeis=seleccionaríeis
selecionarmos=seleccionarmos
selecionas=seleccionas
selecionasse=seleccionasse
selecionásseis=seleccionásseis
selecionassem=seleccionassem
selecionássemos=seleccionássemos
selecionasses=seleccionasses
selecionaste=seleccionaste
selecionastes=seleccionastes
selecionava=seleccionava
selecionavam=seleccionavam
selecionávamos=seleccionávamos
selecionavas=seleccionavas
selecionáveis=seleccionáveis
selecionável=seleccionável
selecione=seleccione
selecionei=seleccionei
selecioneis=seleccioneis
selecionem=seleccionem
selecionemos=seleccionemos
seleciones=selecciones
selecionismo=seleccionismo
selecionismos=seleccionismos
selecionista=seleccionista
selecionistas=seleccionistas
seleciono=selecciono
selecionou=seleccionou
seleções=selecções
seleta=selecta
seletar=selectar
seletares=selectares
seletas=selectas
seletiva=selectiva
seletivamente=selectivamente
seletivas=selectivas
seletividade=selectividade
seletividades=selectividades
seletivo=selectivo
seletivos=selectivos
seleto=selecto
seletor=selector
seletores=selectores
seletos=selectos
semirreta=semi-recta
semirretas=semi-rectas
semirreto=semi-recto
semisselvagem=semi-selvagem
semissom=semi-som
sétupla=séptupla
sétuplas=séptuplas
sétuplo=séptuplo
sicrano=Sicrano
sicranos=Sicranos
simplético=simpléctico
simpléticos=simplécticos
sintática=sintáctica
sintaticamente=sintacticamente
sintáticas=sintácticas
sintaticista=sintacticista
sintaticistas=sintacticistas
sintático=sintáctico
sintáticos=sintácticos
sobre-excita=sobreexcita
sobre-excitação=sobreexcitação
sobre-excitações=sobreexcitações
sobre-excitada=sobreexcitada
sobre-excitadas=sobreexcitadas
sobre-excitado=sobreexcitado
sobre-excitados=sobreexcitados
sobre-excitai=sobreexcitai
sobre-excitais=sobreexcitais
sobre-excitam=sobreexcitam
sobre-excitamos=sobreexcitamos
sobre-excitámos=sobreexcitámos
sobre-excitando=sobreexcitando
sobre-excitar=sobreexcitar
sobre-excitara=sobreexcitara
sobre-excitará=sobreexcitará
sobre-excitaram=sobreexcitaram
sobre-excitáramos=sobreexcitáramos
sobre-excitarão=sobreexcitarão
sobre-excitaras=sobreexcitaras
sobre-excitarás=sobreexcitarás
sobre-excitardes=sobreexcitardes
sobre-excitarei=sobreexcitarei
sobre-excitareis=sobreexcitareis
sobre-excitáreis=sobreexcitáreis
sobre-excitarem=sobreexcitarem
sobre-excitaremos=sobreexcitaremos
sobre-excitares=sobreexcitares
sobre-excitaria=sobreexcitaria
sobre-excitariam=sobreexcitariam
sobre-excitaríamos=sobreexcitaríamos
sobre-excitarias=sobreexcitarias
sobre-excitaríeis=sobreexcitaríeis
sobre-excitarmos=sobreexcitarmos
sobre-excitas=sobreexcitas
sobre-excitasse=sobreexcitasse
sobre-excitásseis=sobreexcitásseis
sobre-excitassem=sobreexcitassem
sobre-excitássemos=sobreexcitássemos
sobre-excitasses=sobreexcitasses
sobre-excitaste=sobreexcitaste
sobre-excitastes=sobreexcitastes
sobre-excitava=sobreexcitava
sobre-excitavam=sobreexcitavam
sobre-excitávamos=sobreexcitávamos
sobre-excitavas=sobreexcitavas
sobre-excitáveis=sobreexcitáveis
sobre-excite=sobreexcite
sobre-excitei=sobreexcitei
sobre-exciteis=sobreexciteis
sobre-excitem=sobreexcitem
sobre-excitemos=sobreexcitemos
sobre-excites=sobreexcites
sobre-excito=sobreexcito
sobre-excitou=sobreexcitou
sobrefaturação=sobrefacturação
sobrefaturações=sobrefacturações
sobrejeção=sobrejecção
sobrejeções=sobrejecções
sobrejetiva=sobrejectiva
sobrejetivas=sobrejectivas
sobrejetivo=sobrejectivo
sobrejetivos=sobrejectivos
socioletais=sociolectais
socioletal=sociolectal
socioleto=sociolecto
socioletos=sociolectos
subaceção=subacepção
subaceções=subacepções
subártica=subárctica
subárticas=subárcticas
subártico=subárctico
subárticos=subárcticos
subcontrato=subcontracto
subcontratos=subcontractos
subdialetais=subdialectais
subdialetal=subdialectal
subdialeto=subdialecto
subdialetos=subdialectos
subdireção=subdirecção
subdireções=subdirecções
subdiretor=subdirector
subdiretora=subdirectora
subdiretoras=subdirectoras
subdiretores=subdirectores
subdiretoria=subdirectoria
subdiretorias=subdirectorias
subdiretório=subdirectório
subdiretórios=subdirectórios
subinspeção=subinspecção
subinspeções=subinspecções
subinspetor=subinspector
subinspetora=subinspectora
subinspetoras=subinspectoras
subinspetores=subinspectores
subinspetoria=subinspectoria
subinspetorias=subinspectorias
subjeção=subjecção
subjeções=subjecções
subjetiva=subjectiva
subjetivação=subjectivação
subjetivações=subjectivações
subjetivada=subjectivada
subjetivadas=subjectivadas
subjetivado=subjectivado
subjetivados=subjectivados
subjetivai=subjectivai
subjetivais=subjectivais
subjetivam=subjectivam
subjetivamente=subjectivamente
subjetivamos=subjectivamos
subjetivámos=subjectivámos
subjetivando=subjectivando
subjetivar=subjectivar
subjetivara=subjectivara
subjetivará=subjectivará
subjetivaram=subjectivaram
subjetiváramos=subjectiváramos
subjetivarão=subjectivarão
subjetivaras=subjectivaras
subjetivarás=subjectivarás
subjetivardes=subjectivardes
subjetivarei=subjectivarei
subjetivareis=subjectivareis
subjetiváreis=subjectiváreis
subjetivarem=subjectivarem
subjetivaremos=subjectivaremos
subjetivares=subjectivares
subjetivaria=subjectivaria
subjetivariam=subjectivariam
subjetivaríamos=subjectivaríamos
subjetivarias=subjectivarias
subjetivaríeis=subjectivaríeis
subjetivarmos=subjectivarmos
subjetivas=subjectivas
subjetivasse=subjectivasse
subjetivásseis=subjectivásseis
subjetivassem=subjectivassem
subjetivássemos=subjectivássemos
subjetivasses=subjectivasses
subjetivaste=subjectivaste
subjetivastes=subjectivastes
subjetivava=subjectivava
subjetivavam=subjectivavam
subjetivávamos=subjectivávamos
subjetivavas=subjectivavas
subjetiváveis=subjectiváveis
subjetive=subjective
subjetivei=subjectivei
subjetiveis=subjectiveis
subjetivem=subjectivem
subjetivemos=subjectivemos
subjetives=subjectives
subjetividade=subjectividade
subjetividades=subjectividades
subjetivismo=subjectivismo
subjetivismos=subjectivismos
subjetivista=subjectivista
subjetivistas=subjectivistas
subjetivístico=subjectivístico
subjetivísticos=subjectivísticos
subjetivizar=subjectivizar
subjetivizares=subjectivizares
subjetivo=subjectivo
subjetivos=subjectivos
subjetivou=subjectivou
subobjetiva=subobjectiva
subobjetivamente=subobjectivamente
subobjetivas=subobjectivas
subobjetividade=subobjectividade
subobjetividades=subobjectividades
subobjetivismo=subobjectivismo
subobjetivismos=subobjectivismos
subobjetivista=subobjectivista
subobjetivistas=subobjectivistas
subobjetivo=subobjectivo
subobjetivos=subobjectivos
subsetor=subsector
subsetores=subsectores
subtração=subtracção
subtrações=subtracções
subtrativamente=subtractivamente
subtrativo=subtractivo
subtrativos=subtractivos
subtrator=subtractor
subtratora=subtractora
subtratoras=subtractoras
subtratores=subtractores
superativado=superactivado
superativados=superactivados
superatividade=superactividade
superatividades=superactividades
superativo=superactivo
superativos=superactivos
superinfeção=superinfecção
superinfeções=superinfecções
superproteção=superprotecção
superproteções=superprotecções
supraestrutura=supra-estrutura
suprarrenais=supra-renais
suprarrenal=supra-renal
suprassumo=supra-sumo
susceção=suscepção
susceções=suscepções
suscetibilidade=susceptibilidade
suscetibilidades=susceptibilidades
suscetibiliza=susceptibiliza
suscetibilizada=susceptibilizada
suscetibilizadas=susceptibilizadas
suscetibilizado=susceptibilizado
suscetibilizados=susceptibilizados
suscetibilizai=susceptibilizai
suscetibilizais=susceptibilizais
suscetibilizam=susceptibilizam
suscetibilizamos=susceptibilizamos
suscetibilizámos=susceptibilizámos
suscetibilizando=susceptibilizando
suscetibilizar=susceptibilizar
suscetibilizara=susceptibilizara
suscetibilizará=susceptibilizará
suscetibilizaram=susceptibilizaram
suscetibilizáramos=susceptibilizáramos
suscetibilizarão=susceptibilizarão
suscetibilizaras=susceptibilizaras
suscetibilizarás=susceptibilizarás
suscetibilizardes=susceptibilizardes
suscetibilizarei=susceptibilizarei
suscetibilizareis=susceptibilizareis
suscetibilizáreis=susceptibilizáreis
suscetibilizarem=susceptibilizarem
suscetibilizaremos=susceptibilizaremos
suscetibilizares=susceptibilizares
suscetibilizaria=susceptibilizaria
suscetibilizariam=susceptibilizariam
suscetibilizaríamos=susceptibilizaríamos
suscetibilizarias=susceptibilizarias
suscetibilizaríeis=susceptibilizaríeis
suscetibilizarmos=susceptibilizarmos
suscetibilizas=susceptibilizas
suscetibilizasse=susceptibilizasse
suscetibilizásseis=susceptibilizásseis
suscetibilizassem=susceptibilizassem
suscetibilizássemos=susceptibilizássemos
suscetibilizasses=susceptibilizasses
suscetibilizaste=susceptibilizaste
suscetibilizastes=susceptibilizastes
suscetibilizava=susceptibilizava
suscetibilizavam=susceptibilizavam
suscetibilizávamos=susceptibilizávamos
suscetibilizavas=susceptibilizavas
suscetibilizáveis=susceptibilizáveis
suscetibilize=susceptibilize
suscetibilizei=susceptibilizei
suscetibilizeis=susceptibilizeis
suscetibilizem=susceptibilizem
suscetibilizemos=susceptibilizemos
suscetibilizes=susceptibilizes
suscetibilizo=susceptibilizo
suscetibilizou=susceptibilizou
suscetíveis=susceptíveis
suscetível=susceptível
suscetivelmente=susceptivelmente
tateabilidade=tacteabilidade
tateabilidades=tacteabilidades
tateada=tacteada
tateadamente=tacteadamente
tateadas=tacteadas
tateado=tacteado
tateados=tacteados
tateai=tacteai
tateais=tacteais
tateamento=tacteamento
tateamentos=tacteamentos
tateamos=tacteamos
tateámos=tacteámos
tateando=tacteando
tateante=tacteante
tateantes=tacteantes
tatear=tactear
tateara=tacteara
tateará=tacteará
tatearam=tactearam
tateáramos=tacteáramos
tatearão=tactearão
tatearas=tactearas
tatearás=tactearás
tateardes=tacteardes
tatearei=tactearei
tateareis=tacteareis
tateáreis=tacteáreis
tatearem=tactearem
tatearemos=tactearemos
tateares=tacteares
tatearia=tactearia
tateariam=tacteariam
tatearíamos=tactearíamos
tatearias=tactearias
tatearíeis=tactearíeis
tatearmos=tactearmos
tateasse=tacteasse
tateásseis=tacteásseis
tateassem=tacteassem
tateássemos=tacteássemos
tateasses=tacteasses
tateaste=tacteaste
tateastes=tacteastes
tateava=tacteava
tateavam=tacteavam
tateávamos=tacteávamos
tateavas=tacteavas
tateáveis=tacteáveis
tateável=tacteável
tateei=tacteei
tateeis=tacteeis
tateemos=tacteemos
tateia=tacteia
tateiam=tacteiam
tateias=tacteias
tateie=tacteie
tateiem=tacteiem
tateies=tacteies
tateio=tacteio
tateios=tacteios
tateou=tacteou
tática=táctica
taticamente=tacticamente
táticas=tácticas
tático=táctico
táticos=tácticos
tato=tacto
tatos=tactos
taoista=taoísta
taoistas=taoístas
tecnoletais=tecnolectais
tecnoletal=tecnolectal
tecnoleto=tecnolecto
tecnoletos=tecnolectos
teto=tecto
tetos=tectos
telerrecetor=tele-receptor
teledeteção=teledetecção
teledeteções=teledetecções
teledetetar=teledetectar
teledetetares=teledetectares
teleobjetiva=teleobjectiva
teleobjetivas=teleobjectivas
teleprojétil=teleprojéctil
teleprojétis=teleprojéctis
telobjetiva=telobjectiva
telobjetivas=telobjectivas
telótico=telóptico
telóticos=telópticos
tenontopético=tenontopéctico
tenontopéticos=tenontopécticos
tenopético=tenopéctico
tenopéticos=tenopécticos
tensioativo=tensioactivo
tensioativos=tensioactivos
termeletricidade=termelectricidade
termeletricidades=termelectricidades
termelétrico=termeléctrico
termelétricos=termeléctricos
termodielétrico=termodieléctrico
termodielétricos=termodieléctricos
termoelétrica=termoeléctrica
termoelétricas=termoeléctricas
termoeletricidade=termoelectricidade
termoeletricidades=termoelectricidades
termoelétrico=termoeléctrico
termoelétricos=termoeléctricos
termotático=termotáctico
termotáticos=termotácticos
tiflopético=tiflopéctico
tiflopéticos=tiflopécticos
tigmotático=tigmotáctico
tigmotáticos=tigmotácticos
toino=tóino
toinos=tóinos
torrefação=torrefacção
torrefações=torrefacções
torrefator=torrefactor
torrefatores=torrefactores
tração=tracção
tracionar=traccionar
tracionares=traccionares
trações=tracções
trato=tracto
tratocarro=tractocarro
tratocarros=tractocarros
trator=tractor
tratores=tractores
tratório=tractório
tratórios=tractórios
tratorista=tractorista
tratoristas=tractoristas
tratos=tractos
trajeto=trajecto
trajetor=trajector
trajetores=trajectores
trajetória=trajectória
trajetórias=trajectórias
trajetos=trajectos
transação=transacção
transaciona=transacciona
transacionada=transaccionada
transacionadas=transaccionadas
transacionado=transaccionado
transacionador=transaccionador
transacionadora=transaccionadora
transacionadoras=transaccionadoras
transacionadores=transaccionadores
transacionados=transaccionados
transacionai=transaccionai
transacionais=transaccionais
transacional=transaccional
transacionam=transaccionam
transacionamos=transaccionamos
transacionámos=transaccionámos
transacionando=transaccionando
transacionar=transaccionar
transacionara=transaccionara
transacionará=transaccionará
transacionaram=transaccionaram
transacionáramos=transaccionáramos
transacionarão=transaccionarão
transacionaras=transaccionaras
transacionarás=transaccionarás
transacionardes=transaccionardes
transacionarei=transaccionarei
transacionareis=transaccionareis
transacionáreis=transaccionáreis
transacionarem=transaccionarem
transacionaremos=transaccionaremos
transacionares=transaccionares
transacionaria=transaccionaria
transacionariam=transaccionariam
transacionaríamos=transaccionaríamos
transacionarias=transaccionarias
transacionaríeis=transaccionaríeis
transacionarmos=transaccionarmos
transacionas=transaccionas
transacionasse=transaccionasse
transacionásseis=transaccionásseis
transacionassem=transaccionassem
transacionássemos=transaccionássemos
transacionasses=transaccionasses
transacionaste=transaccionaste
transacionastes=transaccionastes
transacionava=transaccionava
transacionavam=transaccionavam
transacionávamos=transaccionávamos
transacionavas=transaccionavas
transacionáveis=transaccionáveis
transacionável=transaccionável
transacione=transaccione
transacionei=transaccionei
transacioneis=transaccioneis
transacionem=transaccionem
transacionemos=transaccionemos
transaciones=transacciones
transacionista=transaccionista
transacionistas=transaccionistas
transaciono=transacciono
transacionou=transaccionou
transações=transacções
transata=transacta
transatas=transactas
transato=transacto
transator=transactor
transatora=transactora
transatoras=transactoras
transatores=transactores
transatos=transactos
transcetor=transceptor
transcetores=transceptores
transobjetivo=transobjectivo
transobjetivos=transobjectivos
traquelopético=traquelopéctico
traquelopéticos=traquelopécticos
triboeletricidade=triboelectricidade
triboeletricidades=triboelectricidades
triboelétrico=triboeléctrico
triboelétricos=triboeléctricos
tricorrético=tricorréctico
tricorréticos=tricorrécticos
trirretângulo=trirrectângulo
trirretângulos=trirrectângulos
tumefação=tumefacção
tumefações=tumefacções
turbinosfenoideo=turbinosfenóideo
turbinosfenoideos=turbinosfenóideos
turborreator=turbo-reactor
turborreator=turborreactor
turborreatores=turborreactores
ultrarradicais=ultra-radicais
ultrarradical=ultra-radical
ultrarrealismo=ultra-realismo
ultrarrealista=ultra-realista
ultrarrealistas=ultra-realistas
ultrarromântica=ultra-romântica
ultrarromânticas=ultra-românticas
ultrarromântico=ultra-romântico
ultrarromânticos=ultra-românticos
ultrarromantismo=ultra-romantismo
ultrassensíveis=ultra-sensíveis
ultrassensível=ultra-sensível
ultrassom=ultra-som
ultrassónica=ultra-sónica
ultrassónicas=ultra-sónicas
ultrassónico=ultra-sónico
ultrassónicos=ultra-sónicos
ultrassons=ultra-sons
ultracorreção=ultracorrecção
ultracorreções=ultracorrecções
ultracorreto=ultracorrecto
ultracorretos=ultracorrectos
ultraproteção=ultraprotecção
ultraproteções=ultraprotecções
unidirecionais=unidireccionais
unidirecional=unidireccional
ureterenfrático=ureterenfráctico
ureterenfráticos=ureterenfrácticos
uretrofrático=uretrofráctico
uretrofráticos=uretrofrácticos
vasoativo=vasoactivo
vasoativos=vasoactivos
vetação=vectação
vetações=vectações
vetor=vector
vetores=vectores
vetoriais=vectoriais
vetorial=vectorial
vetorizar=vectorizar
vetorizares=vectorizares
vetrice=vectrice
vetrices=vectrices
veem=vêem
vice-diretor=vice-director
vice-diretora=vice-directora
vice-diretoras=vice-directoras
vice-diretores=vice-directores
x-ato=x-acto
zeida=zéida
zeidas=zéidas
zigotático=zigotáctico
zigotáticos=zigotácticos
zoeletricidade=zoelectricidade
zoeletricidades=zoelectricidades
zoelétrico=zoeléctrico
zoelétricos=zoeléctricos
zooeletricidade=zooelectricidade
zooeletricidades=zooelectricidades
zooelétrico=zooeléctrico
zooelétricos=zooeléctricos
zoótico=zoóptico
zoóticos=zoópticos
zootático=zootáctico
zootáticos=zootácticos

