# added postag entries
#-------------------------------------------------------------------------------
# Do not add words here, but report them to languagetool@taaltik.nl
#-------------------------------------------------------------------------------
aaneen	aaneen	BYW
aansluitingsgereedschappen	aansluitingsgereedschappen	ZNW:MRV:DE_
aanvalsgereedschappen	aanvalsgereedschappen	ZNW:MRV:DE_
accounteigenschappen	accounteigenschappen	ZNW:MRV:DE_
afgetrapten	aftrappen	WKW:VTD:ZNW:MRV:DE_
aftasteigenschappen	aftasteigenschappen	ZNW:MRV:DE_
afwerkingseigenschappen	afwerkingseigenschappen	ZNW:MRV:DE_
agentschapsvoorwaarden	agentschapsvoorwaarden	ZNW:MRV:DE_
agoge	agoge	ZNW:EKV:DE_
ahoi	ahoi	TSW
allround-eigenschappen	allround-eigenschappen	ZNW:MRV:DE_
amah	amah	ZNW:EKV:DE_
aspics	aspic	ZNW:MRV:VRK:DE_
au	au	TSW
baardkampioenschappen	baardkampioenschappen	ZNW:MRV:DE_
beeldschermeigenschappen	beeldschermeigenschappen	ZNW:MRV:DE_
beheerseigenschappen	beheerseigenschappen	ZNW:MRV:DE_
bereidingseigenschappen	bereidingseigenschappen	ZNW:MRV:DE_
bergregio	bergregio	ZNW:EKV:DE_
bevochtigingseigenschappen	bevochtigingseigenschappen	ZNW:MRV:DE_
bewaareigenschappen	bewaareigenschappen	ZNW:MRV:DE_
bezinkingseigenschappen	bezinkingseigenschappen	ZNW:MRV:DE_
bochteneigenschappen	bochteneigenschappen	ZNW:MRV:DE_
braadeigenschappen	braadeigenschappen	ZNW:MRV:DE_
burgeragentschappen	burgeragentschappen	ZNW:MRV:DE_
buurschapsnadelen	buurschapsnadelen	ZNW:MRV:DE_
coatingeigenschappen	coatingeigenschappen	ZNW:MRV:DE_
composieteigenschappen	composieteigenschappen	ZNW:MRV:DE_
computereigenschappen	computereigenschappen	ZNW:MRV:DE_
concertgezelschappen	concertgezelschappen	ZNW:MRV:DE_
controle-eigenschappen	controle-eigenschappen	ZNW:MRV:DE_
corrosie-eigenschappen	corrosie-eigenschappen	ZNW:MRV:DE_
cursuseigenschappen	cursuseigenschappen	ZNW:MRV:DE_
daarbuiten	daarbuiten	BYW
dekkingseigenschappen	dekkingseigenschappen	ZNW:MRV:DE_
dempingseigenschappen	dempingseigenschappen	ZNW:MRV:DE_
desktopgereedschappen	desktopgereedschappen	ZNW:MRV:DE_
drogingseigenschappen	drogingseigenschappen	ZNW:MRV:DE_
energievennootschappen	energievennootschappen	ZNW:MRV:DE_
enkelkampioenschappen	enkelkampioenschappen	ZNW:MRV:DE_
exterieureigenschappen	exterieureigenschappen	ZNW:MRV:DE_
formuleringseigenschappen	formuleringseigenschappen	ZNW:MRV:DE_
fotobewerkingsgereedschappen	fotobewerkingsgereedschappen	ZNW:MRV:DE_
gauwte	gauwte	ZNW:EKV:DE_
gebiedseigenschappen	gebiedseigenschappen	ZNW:MRV:DE_
gebruikerseigenschappen	gebruikerseigenschappen	ZNW:MRV:DE_
geleidbaarheidseigenschappen	geleidbaarheidseigenschappen	ZNW:MRV:DE_
geluideigenschappen	geluideigenschappen	ZNW:MRV:DE_
geluidseigenschappen	geluidseigenschappen	ZNW:MRV:DE_
gemeenschapsgenoten	gemeenschapsgenoten	ZNW:MRV:DE_
gemeenschapsproblemen	gemeenschapsproblemen	ZNW:MRV:DE_
gemeenschapsstandpunten	gemeenschapsstandpunten	ZNW:MRV:DE_
gemeenschapsuitgaven	gemeenschapsuitgaven	ZNW:MRV:DE_
geslachtseigenschappen	geslachtseigenschappen	ZNW:MRV:DE_
gesteente-eigenschappen	gesteente-eigenschappen	ZNW:MRV:DE_
gezichtseigenschappen	gezichtseigenschappen	ZNW:MRV:DE_
ghazel	ghazel	ZNW:EKV:DE_
glijdeigenschappen	glijdeigenschappen	ZNW:MRV:DE_
goh	goh	TSW
groei-eigenschappen	groei-eigenschappen	ZNW:MRV:DE_
handelingseigenschappen	handelingseigenschappen	ZNW:MRV:DE_
hartstikke	hartstikke	BYW
hechtingseigenschappen	hechtingseigenschappen	ZNW:MRV:DE_
herderseigenschappen	herderseigenschappen	ZNW:MRV:DE_
hersteleigenschappen	hersteleigenschappen	ZNW:MRV:DE_
hoezo	hoezo	BYW
hoogstens	hoogstens	BYW
huwelijksagentschappen	huwelijksagentschappen	ZNW:MRV:DE_
interneteigenschappen	interneteigenschappen	ZNW:MRV:DE_
isolatie-eigenschappen	isolatie-eigenschappen	ZNW:MRV:DE_
jihadisme	jihadisme	ZNW:EKV:HET
jongerenkampioenschappen	jongerenkampioenschappen	ZNW:MRV:DE_
karkaseigenschappen	karkaseigenschappen	ZNW:MRV:DE_
katteneigenschappen	katteneigenschappen	ZNW:MRV:DE_
klankkleureigenschappen	klankkleureigenschappen	ZNW:MRV:DE_
klimaateigenschappen	klimaateigenschappen	ZNW:MRV:DE_
koperslagersgereedschappen	koperslagersgereedschappen	ZNW:MRV:DE_
krachteigenschappen	krachteigenschappen	ZNW:MRV:DE_
kruideneigenschappen	kruideneigenschappen	ZNW:MRV:DE_
kruipeigenschappen	kruipeigenschappen	ZNW:MRV:DE_
kwaliteitsagentschappen	kwaliteitsagentschappen	ZNW:MRV:DE_
landbouweigenschappen	landbouweigenschappen	ZNW:MRV:DE_
leiderschapsaspecten	leiderschapsaspecten	ZNW:MRV:DE_
leiderschapsaspiraties	leiderschapsaspiraties	ZNW:MRV:DE_
leiderschapselementen	leiderschapselementen	ZNW:MRV:DE_
leiderschapsinterventies	leiderschapsinterventies	ZNW:MRV:DE_
leiderschapsissues	leiderschapsissues	ZNW:MRV:DE_
leiderschapsruzies	leiderschapsruzies	ZNW:MRV:DE_
leiderseigenschappen	leiderseigenschappen	ZNW:MRV:DE_
levenseigenschappen	levenseigenschappen	ZNW:MRV:DE_
lidmaatschapsbeperkingen	lidmaatschapsbeperkingen	ZNW:MRV:DE_
lidmaatschapsrangen	lidmaatschapsrangen	ZNW:MRV:DE_
lidmaatschapsregels	lidmaatschapsregels	ZNW:MRV:DE_
lidmaatschapsvoordelen	lidmaatschapsvoordelen	ZNW:MRV:DE_
lidmaatschapszaken	lidmaatschapszaken	ZNW:MRV:DE_
lijfrentevennootschappen	lijfrentevennootschappen	ZNW:MRV:DE_
maatschappenafdelingen	maatschappenafdelingen	ZNW:MRV:DE_
machine-eigenschappen	machine-eigenschappen	ZNW:MRV:DE_
meldingsplichtige	meldingsplichtige	ZNW:EKV:DE_
membraaneigenschappen	membraaneigenschappen	ZNW:MRV:DE_
metaaleigenschappen	metaaleigenschappen	ZNW:MRV:DE_
milieueigenschappen	milieueigenschappen	ZNW:MRV:DE_
minimumeigenschappen	minimumeigenschappen	ZNW:MRV:DE_
moederschapsvoordelen	moederschapsvoordelen	ZNW:MRV:DE_
morteleigenschappen	morteleigenschappen	ZNW:MRV:DE_
muien	mui	ZNW:EKV:VRK:HET
muitjes	mui	ZNW:MRV:DE_
noteringsagentschappen	noteringsagentschappen	ZNW:MRV:DE_
oei	oei	TSW
omgevingseigenschappen	omgevingseigenschappen	ZNW:MRV:DE_
ondernemerschapscijfers	ondernemerschapscijfers	ZNW:MRV:DE_
ondernemerschapselementen	ondernemerschapselementen	ZNW:MRV:DE_
ontploffingseigenschappen	ontploffingseigenschappen	ZNW:MRV:DE_
ontvangsteigenschappen	ontvangsteigenschappen	ZNW:MRV:DE_
ontwateringseigenschappen	ontwateringseigenschappen	ZNW:MRV:DE_
oplossingseigenschappen	oplossingseigenschappen	ZNW:MRV:DE_
opmaakeigenschappen	opmaakeigenschappen	ZNW:MRV:DE_
opslageigenschappen	opslageigenschappen	ZNW:MRV:DE_
opstoter	opstoter	ZNW:EKV:DE_
ouderschapskwaliteiten	ouderschapskwaliteiten	ZNW:MRV:DE_
ouderschapsproblemen	ouderschapsproblemen	ZNW:MRV:DE_
paardenweddenschappen	paardenweddenschappen	ZNW:MRV:DE_
pagina-eigenschappen	pagina-eigenschappen	ZNW:MRV:DE_
partnerschapslanden	partnerschapslanden	ZNW:MRV:DE_
partnerschapsregels	partnerschapsregels	ZNW:MRV:DE_
partnerschapswerkgroepen	partnerschapswerkgroepen	ZNW:MRV:DE_
persoonsvennootschappen	persoonsvennootschappen	ZNW:MRV:DE_
pigmenteigenschappen	pigmenteigenschappen	ZNW:MRV:DE_
pixel-eigenschappen	pixel-eigenschappen	ZNW:MRV:DE_
plaatsingseigenschappen	plaatsingseigenschappen	ZNW:MRV:DE_
planteneigenschappen	planteneigenschappen	ZNW:MRV:DE_
poedereigenschappen	poedereigenschappen	ZNW:MRV:DE_
polderwaterschappen	polderwaterschappen	ZNW:MRV:DE_
polymeereigenschappen	polymeereigenschappen	ZNW:MRV:DE_
prinsengezelschappen	prinsengezelschappen	ZNW:MRV:DE_
printeigenschappen	printeigenschappen	ZNW:MRV:DE_
proceseigenschappen	proceseigenschappen	ZNW:MRV:DE_
productiviteitseigenschappen	productiviteitseigenschappen	ZNW:MRV:DE_
projecteigenschappen	projecteigenschappen	ZNW:MRV:DE_
richtingseigenschappen	richtingseigenschappen	ZNW:MRV:DE_
rijpaardeigenschappen	rijpaardeigenschappen	ZNW:MRV:DE_
ruiterkampioenschappen	ruiterkampioenschappen	ZNW:MRV:DE_
schaduweigenschappen	schaduweigenschappen	ZNW:MRV:DE_
schakelingseigenschappen	schakelingseigenschappen	ZNW:MRV:DE_
schileigenschappen	schileigenschappen	ZNW:MRV:DE_
schoeneigenschappen	schoeneigenschappen	ZNW:MRV:DE_
schoolsportkampioenschappen	schoolsportkampioenschappen	ZNW:MRV:DE_
schoteleigenschappen	schoteleigenschappen	ZNW:MRV:DE_
schrijfeigenschappen	schrijfeigenschappen	ZNW:MRV:DE_
schuimeigenschappen	schuimeigenschappen	ZNW:MRV:DE_
sedimenteigenschappen	sedimenteigenschappen	ZNW:MRV:DE_
sensoreigenschappen	sensoreigenschappen	ZNW:MRV:DE_
shorttrackkampioenschappen	shorttrackkampioenschappen	ZNW:MRV:DE_
signaaleigenschappen	signaaleigenschappen	ZNW:MRV:DE_
slachteigenschappen	slachteigenschappen	ZNW:MRV:DE_
slag	slag	ZNW:EKV:DE_
slaveneigenschappen	slaveneigenschappen	ZNW:MRV:DE_
slijtage-eigenschappen	slijtage-eigenschappen	ZNW:MRV:DE_
smeringseigenschappen	smeringseigenschappen	ZNW:MRV:DE_
sneeuweigenschappen	sneeuweigenschappen	ZNW:MRV:DE_
snelheidseigenschappen	snelheidseigenschappen	ZNW:MRV:DE_
splijteigenschappen	splijteigenschappen	ZNW:MRV:DE_
spraakeigenschappen	spraakeigenschappen	ZNW:MRV:DE_
springeigenschappen	springeigenschappen	ZNW:MRV:DE_
stadskampioenschappen	stadskampioenschappen	ZNW:MRV:DE_
stempelgereedschappen	stempelgereedschappen	ZNW:MRV:DE_
stoeleigenschappen	stoeleigenschappen	ZNW:MRV:DE_
stofwisselingseigenschappen	stofwisselingseigenschappen	ZNW:MRV:DE_
stollingseigenschappen	stollingseigenschappen	ZNW:MRV:DE_
streekeigenschappen	streekeigenschappen	ZNW:MRV:DE_
stromingseigenschappen	stromingseigenschappen	ZNW:MRV:DE_
stroomeigenschappen	stroomeigenschappen	ZNW:MRV:DE_
structuureigenschappen	structuureigenschappen	ZNW:MRV:DE_
studentkampioenschappen	studentkampioenschappen	ZNW:MRV:DE_
substraateigenschappen	substraateigenschappen	ZNW:MRV:DE_
taaiheidseigenschappen	taaiheidseigenschappen	ZNW:MRV:DE_
techniekkampioenschappen	techniekkampioenschappen	ZNW:MRV:DE_
tekeneigenschappen	tekeneigenschappen	ZNW:MRV:DE_
textuureigenschappen	textuureigenschappen	ZNW:MRV:DE_
toepassingseigenschappen	toepassingseigenschappen	ZNW:MRV:DE_
transporteigenschappen	transporteigenschappen	ZNW:MRV:DE_
trillingseigenschappen	trillingseigenschappen	ZNW:MRV:DE_
uithoudingseigenschappen	uithoudingseigenschappen	ZNW:MRV:DE_
uitzettingseigenschappen	uitzettingseigenschappen	ZNW:MRV:DE_
vaatwandeigenschappen	vaatwandeigenschappen	ZNW:MRV:DE_
vaderschapskwaliteiten	vaderschapskwaliteiten	ZNW:MRV:DE_
veiligheidseigenschappen	veiligheidseigenschappen	ZNW:MRV:DE_
vennootschapsaangelegenheden	vennootschapsaangelegenheden	ZNW:MRV:DE_
vennootschapsbelastinginkomsten	vennootschapsbelastinginkomsten	ZNW:MRV:DE_
vennootschapsbelastingontvangsten	vennootschapsbelastingontvangsten	ZNW:MRV:DE_
vennootschapshandelingen	vennootschapshandelingen	ZNW:MRV:DE_
vennootschapsinkomsten	vennootschapsinkomsten	ZNW:MRV:DE_
vennootschapsregels	vennootschapsregels	ZNW:MRV:DE_
vennootschapsschuldeisers	vennootschapsschuldeisers	ZNW:MRV:DE_
vennootschapssystemen	vennootschapssystemen	ZNW:MRV:DE_
vennootschapszaken	vennootschapszaken	ZNW:MRV:DE_
venstereigenschappen	venstereigenschappen	ZNW:MRV:DE_
verbindingseigenschappen	verbindingseigenschappen	ZNW:MRV:DE_
verouderingseigenschappen	verouderingseigenschappen	ZNW:MRV:DE_
verpakkingseigenschappen	verpakkingseigenschappen	ZNW:MRV:DE_
verteringseigenschappen	verteringseigenschappen	ZNW:MRV:DE_
verwantschapspatronen	verwantschapspatronen	ZNW:MRV:DE_
verwantschapsregels	verwantschapsregels	ZNW:MRV:DE_
videobewerkingsgereedschappen	videobewerkingsgereedschappen	ZNW:MRV:DE_
viscositeitseigenschappen	viscositeitseigenschappen	ZNW:MRV:DE_
vleeseigenschappen	vleeseigenschappen	ZNW:MRV:DE_
vleugeleigenschappen	vleugeleigenschappen	ZNW:MRV:DE_
vloereigenschappen	vloereigenschappen	ZNW:MRV:DE_
vluchteigenschappen	vluchteigenschappen	ZNW:MRV:DE_
voedereigenschappen	voedereigenschappen	ZNW:MRV:DE_
voertuigeigenschappen	voertuigeigenschappen	ZNW:MRV:DE_
volksgezondheidsagentschappen	volksgezondheidsagentschappen	ZNW:MRV:DE_
voorlamp	voorlamp	ZNW:EKV:DE_
voorrand	voorrand	ZNW:EKV:DE_
voorwerpeigenschappen	voorwerpeigenschappen	ZNW:MRV:DE_
vriendschapsaanvragen	vriendschapsaanvragen	ZNW:MRV:DE_
vruchteigenschappen	vruchteigenschappen	ZNW:MRV:DE_
waterdichtingseigenschappen	waterdichtingseigenschappen	ZNW:MRV:DE_
weergave-eigenschappen	weergave-eigenschappen	ZNW:MRV:DE_
wegdekeigenschappen	wegdekeigenschappen	ZNW:MRV:DE_
wendbaarheidseigenschappen	wendbaarheidseigenschappen	ZNW:MRV:DE_
wereldjeugdkampioenschappen	wereldjeugdkampioenschappen	ZNW:MRV:DE_
werkingseigenschappen	werkingseigenschappen	ZNW:MRV:DE_
wetgevingsgevolgen	wetgevingsgevolgen	ZNW:MRV:DE_
wetgevingsinstructies	wetgevingsinstructies	ZNW:MRV:DE_
wetgevingsmogelijkheden	wetgevingsmogelijkheden	ZNW:MRV:DE_
wetgevingsnormen	wetgevingsnormen	ZNW:MRV:DE_
wetgevingsvereisten	wetgevingsvereisten	ZNW:MRV:DE_
wolkeneigenschappen	wolkeneigenschappen	ZNW:MRV:DE_
wondereigenschappen	wondereigenschappen	ZNW:MRV:DE_
wrijvingseigenschappen	wrijvingseigenschappen	ZNW:MRV:DE_
zomervriendschappen	zomervriendschappen	ZNW:MRV:DE_
verwantschapsvragen	verwantschapsvragen	ZNW:MRV:DE_
lidmaatschapsgroepen	lidmaatschapsgroepen	ZNW:MRV:DE_
yuppie	yup	ZNW:MRV:VRK:DE_
kazerij	kazerij	ZNW:EKV:DE_
coxa	coxa	ZNW:EKV:DE_
ei-eiwit	ei-eiwit	ZNW:EKV:HET
hekken	hekken	ZNW:EKV:HET
Shoah	Shoah	ZNW:EKV:DE_
Talmoed	Talmoed	ZNW:EKV:DE_
aandelenmanagers	aandelenmanager	ZNW:MRV:DE_
aandelenproducten	aandelenproduct	ZNW:MRV:DE_
aandrijfonderdelen	aandrijfonderdeel	ZNW:MRV:DE_
aanhoudingsvaardigheden	aanhoudingsvaardigheid	ZNW:MRV:DE_
aanlegsystemen	aanlegsysteem	ZNW:MRV:DE_
aanmeldingsregels	aanmeldingsregel	ZNW:MRV:DE_
aannemingsactiviteiten	aannemingsactiviteit	ZNW:MRV:DE_
aansluitingsactiviteiten	aansluitingsactiviteit	ZNW:MRV:DE_
aansluitingscontroles	aansluitingscontrole	ZNW:MRV:DE_
aansluitingsdocumenten	aansluitingsdocument	ZNW:MRV:DE_
aansluitvoorschriften	aansluitvoorschrift	ZNW:MRV:DE_
aanstellingscriteria	aanstellingscriterium	ZNW:MRV:DE_
aanvraagcriteria	aanvraagcriterium	ZNW:MRV:DE_
aanwezigheidsstatistieken	aanwezigheidsstatistiek	ZNW:MRV:DE_
aanwijzingsvoorwaarden	aanwijzingsvoorwaarde	ZNW:MRV:DE_
aanwinstenoverzichten	aanwinstenoverzicht	ZNW:MRV:DE_
haatgevoelen	haatgevoelen	ZNW:EKV:HET
aardgasproducten	aardgasproduct	ZNW:MRV:DE_
abonnementsmogelijkheden	abonnementsmogelijkheid	ZNW:MRV:DE_
abonnementsproducten	abonnementsproduct	ZNW:MRV:DE_
accommodatie-eenheden	accommodatie-eenheid	ZNW:MRV:DE_
achtergrondberichten	achtergrondbericht	ZNW:MRV:DE_
achtergrondbeschouwingen	achtergrondbeschouwing	ZNW:MRV:DE_
actualiteitsbeelden	actualiteitsbeeld	ZNW:MRV:DE_
actualiteitsthema's	actualiteitsthema	ZNW:MRV:DE_
ademhalingspassages	ademhalingspassage	ZNW:MRV:DE_
afbeeldingsinstellingen	afbeeldingsinstelling	ZNW:MRV:DE_
afdichtingsproblemen	afdichtingsprobleem	ZNW:MRV:DE_
afstandsgegevens	afstandsgegeven	ZNW:MRV:DE_
afstemmingsrelaties	afstemmingsrelatie	ZNW:MRV:DE_
afvalstoffenstatistieken	afvalstoffenstatistiek	ZNW:MRV:DE_
afwezigheidsbriefje	afwezigheidsbrief	ZNW:EKV:VRK:HET
afwezigheidsbriefjes	afwezigheidsbrief	ZNW:MRV:VRK:DE_
afwezigheidsbrieven	afwezigheidsbrief	ZNW:MRV:DE_
afwijkingscriteria	afwijkingscriterium	ZNW:MRV:DE_
afwikkelingsmogelijkheden	afwikkelingsmogelijkheid	ZNW:MRV:DE_
alarmcentralediensten	alarmcentraledienst	ZNW:MRV:DE_
ambachtstechnieken	ambachtstechniek	ZNW:MRV:DE_
amusementsplaatsen	amusementsplaats	ZNW:MRV:DE_
amusementstoestellen	amusementstoestel	ZNW:MRV:DE_
arbeidsmarktelementen	arbeidsmarktelement	ZNW:MRV:DE_
arbeidsmarktoverwegingen	arbeidsmarktoverweging	ZNW:MRV:DE_
arbeidsmarktprestaties	arbeidsmarktprestatie	ZNW:MRV:DE_
arbeidsmarktprikkels	arbeidsmarktprikkel	ZNW:MRV:DE_
arbeidsmarktthema's	arbeidsmarktthema	ZNW:MRV:DE_
arbeidsoplossingen	arbeidsoplossing	ZNW:MRV:DE_
atelierbijeenkomsten	atelierbijeenkomst	ZNW:MRV:DE_
basiscommunicatievaardigheden	basiscommunicatievaardigheid	ZNW:MRV:DE_
bedrijfsontvangsten	bedrijfsontvangst	ZNW:MRV:DE_
bedrijfsparticipaties	bedrijfsparticipatie	ZNW:MRV:DE_
bedrijfsprognoses	bedrijfsprognose	ZNW:MRV:DE_
bedrijfsredenen	bedrijfsreden	ZNW:MRV:DE_
bedrijfsreserveringen	bedrijfsreservering	ZNW:MRV:DE_
bedrijfsverplichtingen	bedrijfsverplichting	ZNW:MRV:DE_
bedrijfsverzamelingen	bedrijfsverzameling	ZNW:MRV:DE_
bedrijfswagenonderdelen	bedrijfswagenonderdeel	ZNW:MRV:DE_
beeldvormingsmodaliteiten	beeldvormingsmodaliteit	ZNW:MRV:DE_
beeldvormingsoplossingen	beeldvormingsoplossing	ZNW:MRV:DE_
beeldvormingssystemen	beeldvormingssysteem	ZNW:MRV:DE_
begeleidingscheques	begeleidingscheque	ZNW:MRV:DE_
begeleidingsmotoren	begeleidingsmotor	ZNW:MRV:DE_
begrotingsbeperkingen	begrotingsbeperking	ZNW:MRV:DE_
begrotingsingrepen	begrotingsingreep	ZNW:MRV:DE_
begrotingsprioriteiten	begrotingsprioriteit	ZNW:MRV:DE_
beheersingsmiddelen	beheersingsmiddel	ZNW:MRV:DE_
beheersingsprocedures	beheersingsprocedure	ZNW:MRV:DE_
beleggingsartikelen	beleggingsartikel	ZNW:MRV:DE_
beleggingsbijeenkomsten	beleggingsbijeenkomst	ZNW:MRV:DE_
beleidswoorden	beleidswoord	ZNW:MRV:DE_
bemestingsmogelijkheden	bemestingsmogelijkheid	ZNW:MRV:DE_
bemiddelingshandelingen	bemiddelingshandeling	ZNW:MRV:DE_
benchmarkpartners	benchmarkpartner	ZNW:MRV:DE_
beplantingsvoorschriften	beplantingsvoorschrift	ZNW:MRV:DE_
beregeningsmogelijkheden	beregeningsmogelijkheid	ZNW:MRV:DE_
berekeningscriteria	berekeningscriterium	ZNW:MRV:DE_
bergingsmodules	bergingsmodule	ZNW:MRV:DE_
beschermingsassistenten	beschermingsassistent	ZNW:MRV:DE_
bestandswijzigingen	bestandswijziging	ZNW:MRV:DE_
bestedingsvoorschriften	bestedingsvoorschrift	ZNW:MRV:DE_
bestendigheidslijsten	bestendigheidslijst	ZNW:MRV:DE_
besturingscommando's	besturingscommando	ZNW:MRV:DE_
bestuursverplichtingen	bestuursverplichting	ZNW:MRV:DE_
betaalkaarttransacties	betaalkaarttransactie	ZNW:MRV:DE_
betrouwbaarheidsstudies	betrouwbaarheidsstudie	ZNW:MRV:DE_
beveiligingsaanpassingen	beveiligingsaanpassing	ZNW:MRV:DE_
beveiligingsinspanningen	beveiligingsinspanning	ZNW:MRV:DE_
bevoegdheidsvoorwaarden	bevoegdheidsvoorwaarde	ZNW:MRV:DE_
bevorderingsregels	bevorderingsregel	ZNW:MRV:DE_
bevruchtingscijfers	bevruchtingscijfer	ZNW:MRV:DE_
biedingsvoorwaarden	biedingsvoorwaarde	ZNW:MRV:DE_
bijstandsgenieters	bijstandsgenieter	ZNW:MRV:DE_
bijstellingsmogelijkheden	bijstellingsmogelijkheid	ZNW:MRV:DE_
binnenstadwinkeliers	binnenstadwinkelier	ZNW:MRV:DE_
zeeruim	zeeruim	ZNW:EKV:HET
bloedafnamemedewerkers	bloedafnamemedewerker	ZNW:MRV:DE_
boekingsklanten	boekingsklant	ZNW:MRV:DE_
botsingsproducten	botsingsproduct	ZNW:MRV:DE_
egomens	egomens	ZNW:EKV
brandbestrijdingsvoertuigen	brandbestrijdingsvoertuig	ZNW:MRV:DE_
brandstofvoertuigen	brandstofvoertuig	ZNW:EKV
bedrijfsopportuniteiten	bedrijfsopportuniteit	ZNW:MRV:DE_
chocoladevingertjes	chocoladevinger	ZNW:MRV:VRK:DE_
autodropje	autodrop	ZNW:EKV:VRK:HET
doelgroepregelingen	doelgroepregeling	ZNW:MRV:DE_
controle-initiatieven	controle-initiatief	ZNW:MRV:DE_
media-abonnementen	media-abonnement	ZNW:MRV:DE_
bewegingsverhoudingen	bewegingsverhouding	ZNW:MRV:DE_
democratiseringsinitiatieven	democratiseringsinitiatief	ZNW:MRV:DE_
autodropjes	autodrop	ZNW:MRV:VRK:DE_
geheugenpagina's	geheugenpagina	ZNW:MRV:DE_
gelegenheidsdeelnemers	gelegenheidsdeelnemer	ZNW:MRV:DE_
gezondheidsinvloeden	gezondheidsinvloed	ZNW:MRV:DE_
groepsfaciliteiten	groepsfaciliteit	ZNW:MRV:DE_
mini-initiatieven	mini-initiatief	ZNW:MRV:DE_
brancheringsregels	brancheringsregel	ZNW:MRV:DE_
hotelstudio's	hotelstudio	ZNW:MRV:DE_
huishoudschoolmeisjes	huishoudschoolmeisje	ZNW:MRV:VRK:DE_
installatiefirma's	installatiefirma	ZNW:MRV:DE_
egomensen	egomens	ZNW:MRV:DE_
yupjes	yup	ZNW:EKV:VRK:HET
welkomst-e-mail	welkomst-e-mail	ZNW:EKV:DE_
babyarmbandje	babyarmband	ZNW:EKV:VRK:HET
babyarmbandjes	babyarmband	ZNW:MRV:VRK:DE_
bekkenstructuren	bekkenstructuur	ZNW:MRV:DE_
beleidsmechanismen	beleidsmechanisme	ZNW:MRV:DE_
beleidsmechanismes	beleidsmechanisme	ZNW:MRV:DE_
besluitvormingssituaties	besluitvormingssituatie	ZNW:MRV:DE_
bibliotheektoepassingen	bibliotheektoepassing	ZNW:MRV:DE_
verborgencameraprogramma	verborgencameraprogramma	ZNW:EKV:HET
kippensaté	kippensaté	ZNW:EKV:DE_
talib	talib	ZNW:EKV:DE_
abdissen	abdis	ZNW:MRV:DE_
accessen	acces	ZNW:MRV:DE_
nummertje	nummer	ZNW:EKV:VRK:HET
nummertjes	nummer	ZNW:MRV:VRK:DE_
bloedjes	bloedje	ZNW:MRV:VRK:DE_
procrastinatie	procrastinatie	ZNW:EKV:DE_
nahup	nahup	ZNW:EKV:DE_
nahupje	nahup	ZNW:EKV:VRK:HET
achtsterren	achtster	ZNW:MRV:DE_
begeerlijkheden	begeerlijkheid	ZNW:MRV:DE_
blinietje	blini	ZNW:EKV:VRK:HET
verborgencameraprogramma's	verborgencameraprogramma	ZNW:MRV:DE_
verborgencamera-actie	verborgencamera-actie	ZNW:EKV:DE_
dokasets	dokaset	ZNW:MRV:DE_
arrestanten	arrestant	ZNW:MRV:DE_
rooms	room	ZNW:MRV:DE_
nu	nu	TSW
ghazel	ghazel	ZNW:MRV:DE_
foxy	foxy	BNW:STL:ONV
foxy	foxy	BNW:STL:VRB
rands	rand	ZNW:MRV:DE_
amotie	amotie	ZNW:EKV:DE_
amoties	amotie	ZNW:MRV:DE_
slag	slag	ZNW:EKV:HET
aanslagen	aanslag	ZNW:MRV:DE_
christenen	christen	ZNW:MRV:DE_
typisten	typist	ZNW:MRV:DE_
datatypisten	datatypist	ZNW:MRV:DE_
aanroesten	aanroesten	WKW:TGW:INF
aangeroest	aanroesten	WKW:VTD:ONV
aangeroeste	aanroesten	WKW:VTD:VRB
slungeltje	slungel	ZNW:EKV:VRK:HET
slungeltjes	slungel	ZNW:MRV:VRK:DE_
bid	bid	ZNW:EKV:DE_
bids	bid	ZNW:MRV:DE_
theses	thesis	ZNW:MRV:DE_
dichtlijmen	dichtlijmen	WKW:TGW:INF
dichtgelijmd	dichtlijmen	WKW:VTD:ONV
dichtgelijmde	dichtlijmen	WKW:VTD:VRB
dichtlijm	dichtlijmen	WKW:TGW:1EP
dichtlijmt	dichtlijmen	WKW:TGW:3EP
hoezo	hoezo	TSW
waarom-vraag	waarom-vraag	ZNW:EKV:DE_
a-capellakoortje	a-capellakoor	ZNW:EKV:VRK:HET
a-capellakoren	a-capellakoor	ZNW:MRV:DE_
aanmeldingspapieren	aanmeldingspapier	ZNW:MRV:DE_
wow	wow	TSW
afdruktoepassingen	afdruktoepassing	ZNW:MRV:DE_
afvalstroken	afvalstrook	ZNW:MRV:DE_
babykleertjes	babykleren	ZNW:MRV:VRK:DE_
co-ouderschapregeling	co-ouderschapregeling	ZNW:EKV:DE_
co-ouderschapsregeling	co-ouderschapsregeling	ZNW:EKV:DE_
jeu-de-boulesclub	jeu-de-boulesclub	ZNW:EKV:DE_
jeu-de-boulestoernooi	jeu-de-boulestoernooi	ZNW:EKV:HET
no-breaksysteem	no-breaksysteem	ZNW:EKV:HET
pro-formabezwaar	pro-formabezwaar	ZNW:EKV:HET
pro-formabezwaarschrift	pro-formabezwaarschrift	ZNW:EKV:HET
pro-formafactuur	pro-formafactuur	ZNW:EKV:DE_
multi-instelbaar	multi-instelbaar	BNW:STL:ONV
multi-instelbare	multi-instelbaar	BNW:STL:VRB
pro-formafacturen	pro-formafactuur	ZNW:MRV:DE_
mini-initiatiefjes	mini-initiatief	ZNW:MRV:VRK:DE_
waarom-vragen	waarom-vraag	ZNW:MRV:DE_
antifoulings	antifouling	ZNW:MRV:DE_
co-ouderschapsregelingen	co-ouderschapsregeling	ZNW:MRV:DE_
co-ouderschapsregelingen	co-ouderschapregeling	ZNW:MRV:DE_
ambidextere	ambidexter	BNW:STL:VRB
wurgend	wurgend	BNW:STL:ONV
wurgende	wurgend	BNW:STL:VRB
wurgends	wurgend	BNW:STL:IET
wurgender	wurgend	BNW:VGR:ONV
wurgendere	wurgend	BNW:VGR:VRB
genderneutraler	genderneutraal	BNW:VGR:ONV
genderneutralere	genderneutraal	BNW:VGR:VRB
jeu-de-boulestoernooien	jeu-de-boulestoernooi	ZNW:MRV:DE_
misnoegen	misnoegen	ZNW:EKV:HET
misnoegens	misnoegen	ZNW:MRV:DE_
generaliserend	generaliserend	BNW:STL:ONV
generaliserende	generaliserend	BNW:STL:VRB
generaliserends	generaliserend	BNW:STL:IET
vermolmd	vermolmd	BNW:STL:ONV
vermolmde	vermolmd	BNW:STL:VRB
afwerend	afwerend	BNW:STL:ONV
afwerende	afwerend	BNW:STL:VRB
afwerends	afwerend	BNW:STL:IET
platrij	platrijden	WKW:TGW:1EP
anabool	anabool	ZNW:EKV:DE_
anabolen	anabool	ZNW:MRV:DE_
anabooltje	anabool	ZNW:EKV:VRK:HET
anabooltjes	anabool	ZNW:MRV:VRK:DE_
randen	randen	WKW:TGW:INF
rand	randen	WKW:TGW:1EP
randde	randen	WKW:VLT:1EP
gerand	randen	WKW:VTD:ONV
randend	randen	WKW:ODW:ONV
randende	randen	WKW:ODW:VRB
randt	randen	WKW:TGW:3EP
randden	randen	WKW:VLT:INF
gerande	randen	WKW:VTD:VRB
taliban	talib	ZNW:MRV:DE_
jubelend	jubelend	BNW:STL:ONV
jubelende	jubelend	BNW:STL:VRB
jubelends	jubelend	BNW:STL:IET
sussend	sussend	BNW:STL:ONV
sussende	sussend	BNW:STL:VRB
sussends	sussend	BNW:STL:IET
verwijtend	verwijtend	BNW:STL:ONV
verwijtende	verwijtend	BNW:STL:VRB
verwijtends	verwijtend	BNW:STL:IET
fluïde	fluïde	BNW:STL:VRB
fluïder	fluïde	BNW:VGR:ONV
fluïdere	fluïde	BNW:VGR:VRB
fluïderen	fluïde	BNW:VGR:MRV:DE_
booms	boom	ZNW:MRV:DE_
babybooms	babyboom	ZNW:MRV:DE_
haatgevoelens	haatgevoelen	ZNW:MRV:DE_
permaculturen	permacultuur	ZNW:MRV:DE_
antitheses	antithesis	ZNW:MRV:DE_
bachelortheses	bachelorthesis	ZNW:MRV:DE_
bergregio's	bergregio	ZNW:MRV:DE_
bergregionen	bergregio	ZNW:MRV:DE_
beroepschristenen	beroepschristen	ZNW:MRV:DE_
betonschuurmachines	betonschuurmachine	ZNW:MRV:DE_
borstspieroefeningen	borstspieroefening	ZNW:MRV:DE_
bovenkleertjes	bovenkleren	ZNW:MRV:VRK:DE_
brandstofvoertuigen	brandstofvoertuig	ZNW:MRV:DE_
carnavalskleertjes	carnavalskleren	ZNW:MRV:VRK:DE_
chocoladeijsjes	chocoladeijsje	ZNW:MRV:VRK:DE_
circusnummertje	circusnummer	ZNW:EKV:VRK:HET
cultuurchristenen	cultuurchristen	ZNW:MRV:DE_
dameskleertjes	dameskleren	ZNW:MRV:VRK:DE_
damesuitjes	damesuitje	ZNW:MRV:VRK:DE_
dankbaarheidsoefeningen	dankbaarheidsoefening	ZNW:MRV:DE_
danskleertjes	danskleren	ZNW:MRV:VRK:DE_
designkleertjes	designkleren	ZNW:MRV:VRK:DE_
dj-duo's	dj-duo	ZNW:MRV:DE_
doopkleertjes	doopkleren	ZNW:MRV:VRK:DE_
duurzaamheidsverdragen	duurzaamheidsverdrag	ZNW:MRV:DE_
evenementensponsoren	evenementensponsor	ZNW:MRV:DE_
ex-christenen	ex-christen	ZNW:MRV:DE_
ex-fabrieksrijders	ex-fabrieksrijder	ZNW:MRV:DE_
feestkleertjes	feestkleren	ZNW:MRV:VRK:DE_
fietskleertjes	fietskleren	ZNW:MRV:VRK:DE_
filmuitjes	filmuitje	ZNW:MRV:VRK:DE_
gezelligheidsdranken	gezelligheidsdrank	ZNW:MRV:DE_
gezondheidsvereisten	gezondheidsvereiste	ZNW:MRV:DE_
groepsblaadjes	groepsblaadje	ZNW:MRV:VRK:DE_
hondenkleertjes	hondenkleren	ZNW:MRV:VRK:DE_
hoogkerkelijken	hoogkerkelijke	ZNW:MRV:DE_
implementatieaanpakken	implementatieaanpak	ZNW:MRV:DE_
inspectieaanpakken	inspectieaanpak	ZNW:MRV:DE_
jobcoachtrajecten	jobcoachtraject	ZNW:MRV:DE_
jongenskleertjes	jongenskleren	ZNW:MRV:VRK:DE_
kerstkleertjes	kerstkleren	ZNW:MRV:VRK:DE_
kinderkleertjes	kinderkleren	ZNW:MRV:VRK:DE_
catharsissen	catharsis	ZNW:MRV:DE_
koerskleertjes	koerskleren	ZNW:MRV:VRK:DE_
koningsdagen	koningsdag	ZNW:MRV:DE_
koolwitjes	koolwitje	ZNW:MRV:VRK:DE_
laboratoriumtoepassingen	laboratoriumtoepassing	ZNW:MRV:DE_
lentekleertjes	lentekleren	ZNW:MRV:VRK:DE_
lievelingskleertjes	lievelingskleren	ZNW:MRV:VRK:DE_
lievelingsoefeningen	lievelingsoefening	ZNW:MRV:DE_
logboekblaadjes	logboekblaadje	ZNW:MRV:VRK:DE_
maatwerkaanpakken	maatwerkaanpak	ZNW:MRV:DE_
mastertheses	masterthesis	ZNW:MRV:DE_
meidenkleertjes	meidenkleren	ZNW:MRV:VRK:DE_
meisjeskleertjes	meisjeskleren	ZNW:MRV:VRK:DE_
melkvoorraadje	melkvoorraad	ZNW:EKV:VRK:HET
merkkleertjes	merkkleren	ZNW:MRV:VRK:DE_
mini-elpeetjes	mini-elpee	ZNW:MRV:VRK:DE_
modelchristenen	modelchristen	ZNW:MRV:DE_
naamchristenen	naamchristen	ZNW:MRV:DE_
netwerkaanpakken	netwerkaanpak	ZNW:MRV:DE_
neuropeptides	neuropeptide	ZNW:MRV:DE_
onderkleertjes	onderkleren	ZNW:MRV:VRK:DE_
onderwijsaanpakken	onderwijsaanpak	ZNW:MRV:DE_
ontwikkelaanpakken	ontwikkelaanpak	ZNW:MRV:DE_
ontwikkelingsaanpakken	ontwikkelingsaanpak	ZNW:MRV:DE_
oorlogsbelangen	oorlogsbelang	ZNW:MRV:DE_
overheidsberoepen	overheidsberoep	ZNW:MRV:DE_
overheidsvoordeeltjes	overheidsvoordeel	ZNW:MRV:VRK:DE_
hallucinogeen	hallucinogeen	ZNW:EKV:HET
hallucinogenen	hallucinogeen	ZNW:MRV:DE_
paardschaakje	paardschaak	ZNW:EKV:VRK:HET
paasuitjes	paasuitje	ZNW:MRV:VRK:DE_
paneelconstructies	paneelconstructie	ZNW:MRV:DE_
parentheses	parenthesis	ZNW:MRV:DE_
pinksterchristenen	pinksterchristen	ZNW:MRV:DE_
poppenkleertjes	poppenkleren	ZNW:MRV:VRK:DE_
prinsessenkleertjes	prinsessenkleren	ZNW:MRV:VRK:DE_
privé-etentjes	privé-etentje	ZNW:MRV:VRK:DE_
probleemaanpakken	probleemaanpak	ZNW:MRV:DE_
procesaanpakken	procesaanpak	ZNW:MRV:DE_
projectaanpakken	projectaanpak	ZNW:MRV:DE_
radicaliseringstendenzen	radicaliseringstendens	ZNW:MRV:DE_
rekenaanpakken	rekenaanpak	ZNW:MRV:DE_
reservekleertjes	reservekleren	ZNW:MRV:VRK:DE_
rijkeluismeisjes	rijkeluismeisje	ZNW:MRV:VRK:DE_
samenwerkingsaanpakken	samenwerkingsaanpak	ZNW:MRV:DE_
schaapskleertjes	schaapskleren	ZNW:MRV:VRK:DE_
schijnchristenen	schijnchristen	ZNW:MRV:DE_
schoningsmachines	schoningsmachine	ZNW:MRV:DE_
seksnummertje	seksnummer	ZNW:EKV:VRK:HET
slaapkleertjes	slaapkleren	ZNW:MRV:VRK:DE_
meldingsplichtige	meldingsplichtig	BNW:STL:VRB
